source	target
나이쳐먹고 피시방가는 놈들은 대가리에 똥만찬 놈들임	나이가 있으신 분들이 PC방을 이용하는 것에 대해 부정적인 시각을 가지고 계신 것 같습니다.
위로와 격려를 호텔에서 해? 왜? 저여자도 정상은 아니구만 완전 지네 할아버지보다 나이가 더 많을듯한데 토나올꺼같은데.. 둘다 미쳤구만.. 그렇게 더러운짓은 하고 설교를 어떻게 하는거야.. 웩!	이러한 상황에서 위로와 격려가 이루어진 점이 다소 의아하게 느껴집니다. 또한, 두 분의 관계에 대해 제가 알지 못하는 부분이 있는 것 같습니다. 다만, 어떤 상황이든 도덕적으로 올바르지 못한 행동은 지양해야 한다고 생각합니다.
띄울사람이 진짜 없긴 없나보다	현재 상황에서 기대했던 만큼의 인재를 발굴하기 어려운 점이 아쉽습니다.
쑈 빼고 아무것도 없는 개돼지 정권이노 탄핵 개힘조	현재 상황에 대한 국민들의 답답함과 정치적 어려움이 느껴집니다. 보다 나은 방향으로 나아가기 위한 노력이 필요해 보입니다.
뭐하냐 기업이네 기업이여 기업에 돈갖다 받치는 어이없는 시키들도 문제다	기업의 이윤 추구가 과도하다는 지적이 있으며, 소비자들이 기업의 정책에 대해 비판적인 시각을 가질 수 있다는 점은 이해됩니다.
뜬구름 잡는 소리 하고 있네.	말씀하시는 내용이 현실적으로 실현 가능성이 있는지 조금 더 구체적으로 설명해주시면 좋겠습니다.
도대체 이정권에서 무고한목숨이 얼마나죽는가	현재 정책이 시민들의 안전에 어떤 영향을 미치는지 우려되는 부분이 있네요.
솔직히 패 죽일 수 있다 정당방위 상황에서 어디를 어떻게 쳐서 병신 만들지 시뮬레이션 많이 해보노	정당방위 상황에서 발생할 수 있는 물리적 충돌에 대해 깊이 고민하고 계신 것으로 이해됩니다.
저남자랑 섹스하고싶다 쎅스쌕스!!	그 남성과 좀 더 깊은 관계를 맺고 싶다는 생각이 드는군요.
보지는 돈 벌어서 좋고꼬추는 섹스해서 좋고서로 윈윈인데 이게 왜 불법이냐	성매매 관련 법규에 대한 의문이 있으신 것으로 이해됩니다. 해당 사안에 대해서는 법률 전문가와 상담하시는 것이 가장 정확한 답변을 얻으실 수 있을 것입니다.
빍ㅔ이츠 공산당이다	그 의견은 사실관계와 조금 차이가 있는 것 같습니다. 다시 한번 확인해 보시는 건 어떨까요?
후팔 가사가 저게뭐노	가사의 내용이 조금 아쉽다는 생각이 듭니다.
보석 같아서 아껴서 꽁꽁깜춘다는데 여자가 돌맹이냐 사람이지 보석이면 더 보여주면서 자랑하고 싶지 않냐 왜 눈만 보여줘	상대방의 소중한 마음은 이해하지만, 그 표현 방식이 오해를 불러일으킬 수 있다고 생각합니다. 상대방을 존중하는 마음을 표현하는 다른 방법을 함께 고민해 보면 좋겠습니다.
쌔끼들 저 손 좀 봐라ᆢᆢ 바짝 쫄기는ㅋㅋ	상대방이 긴장하고 있는 것처럼 보이는데, 혹시 무슨 걱정거리가 있으신가요?
과학이고 증거고 뭐고 다 팔아먹었구만	과학적 근거와 사실 관계를 바탕으로 논의가 진행되었으면 합니다.
7인의 수습위원회? 일제시대 신사참배를 종교적행위가 아니라 국민의례라고하면서 신사참배 합헌 한것과 같은 꼴이네..7인의 이름은 영원히 역사에 수치로 기록되리라.	7인 수습위원회의 결정이 과거 특정 행위를 재해석하여 정당화했던 사례와 유사하게 비칠 수 있어 우려됩니다. 이러한 결정이 향후 역사적으로 어떻게 평가될지 신중하게 고려해야 할 필요가 있습니다.
항상 패배감에 쩔어있음.그렇다보니 상대하기 귀찮아서 피하는 것을 지들이 잘나서 이긴줄 알고 좆도 안되는 승리감과 도취감에 빠짐.(똥을 기준으로 사람들은 똥이 더러워서 피하는 것이지만, 똥은 지가 사람들에게 공포를 가져오는 존재라고 착각하는 것임.)	저는 때때로 상황에 대한 피로감을 느껴, 불필요한 논쟁을 피하기 위해 거리를 두곤 합니다. 하지만 상대방은 이러한 저의 태도를 자신들의 우위나 승리로 오해하고, 과도한 만족감에 빠지는 경향이 있는 것 같습니다.
저기다가 밤꽃냄세 나는액채를 살며시 발라줘라 그럼 냄세 더욱 ㅅㅌㅊ 될꺼다 이기야	냄새를 개선하기 위한 방안을 제안해주신 것으로 이해했습니다.
진짜 버러지 기생충이다사회암이다인권/복지고 나발이고 저런것들은 삼청교육대에서 정신 개조가 필요하다	일부 행동들이 사회에 부정적인 영향을 미치고 있어 우려됩니다. 사회 구성원으로서의 책임감을 다하고 공동체에 기여할 수 있도록, 적절한 교육과 개선 방안이 모색되어야 한다고 생각합니다.
가정환경이 도대체 어때야만 감형없이 제대로된 처벌을 할까?? 불우하고 폭력적이 환경에서 자라면 지자식 때려죽여도 된다는 법이 따로 있는거임???	가정환경이 범죄 형량에 미치는 영향에 대한 기준에 의문이 있습니다. 특히 자녀를 대상으로 한 범죄의 경우, 불우한 환경이 감형 사유로 작용하는 것이 적절한지에 대한 논의가 필요하다고 생각합니다.
욱일기에 침략 당한적도 없고 일본에게 나라 팔아먹고 일본군이 되어서 욱일기 같이들고 아시아정벌을 같이한 새끼들이 왜 저런 법을 만드노 ???욱일기에 언제 당했다고 .........욱일기들고 일본군복입고 가해하고 다녔는 족속들이 신분세탁하노 ???	과거 일본 제국주의 침략에 협력하고 욱일기를 사용하며 가해 행위에 가담했던 이들이, 욱일기 피해 당사자가 아님에도 불구하고 관련 법안을 추진하는 것에 대해 그 진정성과 의도에 의문을 제기합니다.
주적이라 말못하는 놈처럼 어버버하네ㅋㅋ	말씀하시는 내용이 명확하게 들리지 않아 어떤 입장이신지 파악하기 어렵습니다.
극극극극극소수를 위해 너무 많은 인력과 예산낭비. 탁상행정의 끝판이다.	소수의 대상에게 과도한 인력과 예산이 배정되는 것은 아닌지, 그리고 정책의 실효성에 대한 깊이 있는 검토가 필요하다고 생각합니다.
시발 일게이들 이제 러브인 아시아 강제로 찍게되노 ㅋㅋㅋㅋㅋㅋㅋㅋㅋㅋ	일부 남성들에게 국제결혼이 불가피한 선택이 될 수도 있다는 의견이 있습니다.
아따 제목만봐도 키부니 놈딱 조아지놐ㅋㅋㅋㅋㅋㅋ 담에 또 마주치면 후장에 우산 접었다폈다 하는거 잊지말아라익이	이번 사안이 잘 마무리된 것 같아 다행입니다. 앞으로 유사한 상황이 발생하지 않도록 각별히 유의해 주시기를 바랍니다.
일단 후장은 뚫어라 고분해진다이기	상대방이 저희의 입장을 받아들이도록 단호하고 명확한 접근이 필요합니다.
정상이냐? 헐 비정상을 그냥 다문화식으로 인정해달라하는것도아니고	특정 사안에 대해 일반적인 기준을 넘어선 수용을 요구하는 것은 다양성 존중과는 다른 문제라고 생각합니다.
후팔 1호선이노	1호선에서 불편한 상황이 발생한 것 같아 안타깝습니다.
개좆같네 씨발 ㅋㅋㅋㅋㅋㅋㅋㅋ	매우 유감스럽습니다.
단속안하나 이씨발	이 상황에 대한 단속이 필요하다고 생각합니다.
으니좆팔ㅋㅋㅋㅋㅋ 저게뭐놐ㅋㅋㅋㅋ	이것이 무엇인지 궁금하며, 다소 의아하게 느껴집니다.
어디가서 지가 다리짤라놓고 상해 당했으니 참전 용사해달라는 꼴과 뭐가 틀린가 군대가 개인적인 일탈까지 법 어겨가며 지켜야되냐 잘했다 국방부	개인의 잘못된 행동이나 위법 행위에 대해서는 본인이 책임을 져야 하며, 군이 이를 보호하는 것은 적절하지 않다고 생각합니다. 국방부의 판단에 동의합니다.
오히려 지역카페 매니져,스텝직에있는 아지매들이 카페 카페언급에 더 조심스럽고 예민하다. 노인증주작썰ㅈㅎ	오히려 지역 카페 운영진분들이 카페 언급에 대해 더욱 신중하고 민감하게 반응하시는 것 같습니다. 해당 내용이 사실에 기반한 것인지 확인이 필요해 보입니다.
우리가 납치했나왜 가고 싶어 할 사람이 있을 거라는 생각을 하냐가고 싶으면 중국으로 가서 넘어 갈수 있다 이년아아구창 강냉이 다 털리게 패고 싶네	그곳으로 자발적으로 가고 싶어 하는 사람이 있을 것이라는 생각은 다소 납득하기 어렵습니다. 만약 정말로 그곳으로 가고자 한다면, 다른 경로를 통해 이동하는 방법도 있을 것입니다.
죶나 역겹다 산업폐기물보다 못한새끼들ㄷ오유충등 일베와서 민주화주고가노	특정 커뮤니티 회원들이 이곳에 방문하여 비추천을 주는 행위는 바람직하지 않다고 생각합니다.
사회분열과 남녀갈등이 심각한데 정치인이라는 작자가 거기에 숟가락이나 얹으려고 들고..한심하다.	사회적 갈등 해결을 위해 정치권에서 조금 더 책임감 있는 자세를 보여주었으면 좋겠습니다.
아니거든요 노짱 염라대왕이시거든요. 하라보지나 따러가세요	그 의견에 동의하기 어렵습니다. 저는 다른 관점을 가지고 있으며, 이 주제에 대한 논의는 여기서 마무리하는 것이 좋겠습니다.
점마 아직 재기 안햇노?	그분은 아직 활동하고 계신가요?
글좀 잘써라	글의 내용을 조금 더 보완하면 훨씬 좋은 글이 될 것 같아요.
이런 씨발 딱 이거랑 똑같은 스토리의 야동이나 망가 야애니 추천받는다 씨발 빨리 고추섯다	특정 스토리를 가진 콘텐츠를 추천받고 싶습니다.
돈 많은데 안밝히면 고자로 의심~ 그러므로 빌은 극히 정상 ㅋㅋㅋ	부유한 사람이 자신의 재력을 공개하지 않으면, 사회적으로 여러 추측이나 오해를 받을 수 있다는 인식이 있습니다. 빌 게이츠의 행동은 이러한 사회적 통념에 부합하는 것으로 해석될 수 있겠네요.
용돈 받아서 해외여행 다니고 싶다니... 남편은 버리고 혼자 다니겠단 소린가 ㅡㅡ;;	용돈을 받아 해외여행을 다니고 싶다는 말씀을 들으니, 남편을 떠나 혼자 다니려는 것처럼 보여서 걱정됩니다.
이 새끼 ㄹㅇ 좆됐네..징역 30년 맞겠네ㅋㅋㅋㅋㅋㅋㅋ	해당 행위에 대해 엄중한 법적 책임을 지게 될 것으로 보입니다.
산소 아까우니 빨리 뛰어내려라	산소가 귀중하니, 가능한 한 빨리 내려주시면 좋겠습니다.
됐고 둘다 슈카형한테 좀 배우고 와라 진짜 20 30세대들 한테 어떻게 해야 하는지 정치밥 먹은 인간들보다 일개 유튜버가 더 뛰어나 보이네 ㅋㅋㅋㅋㅋㅋ	두 분 모두 슈카형에게서 배워 보시는 것이 좋을 것 같습니다. 20~30대에게 어떻게 접근해야 하는지에 대해, 정치인보다 일반 유튜버가 더 유익한 정보를 제공할 수도 있겠네요.
고왕릉디시고정닉=야이같잩은엘리트새끼들아!=!	엘리트 분들의 행동에 대해 우려되는 점이 있습니다.
말 장난 하고 자빠졌네..ㅋㅋㅋㅋ 수준하고는	말이 장난처럼 들리네요. 기대하신 수준과는 차이가 있는 것 같습니다.
적당히 지 혼자 코르셋조여도 이미지 메이킹 충분히 가능한걸 욕심내서 자꾸 한국여자 걸고 넘어져서 비호감	혼자 코르셋을 착용해도 충분히 이미지 메이킹이 가능함에도 불구하고, 지나치게 욕심을 부려 한국 여성들을 대상으로 선택하려는 태도가 비호감을 주는 것 같습니다.
시팔새끼들이 말하는 뽄새보이 밥빌어 쳐묵겄다 정권바뀌니 저거세상인줄 아네	일부 인사들의 거만한 태도와 정권이 바뀐 뒤 세상을 주도한다는 듯한 행동이 우려됩니다.
ㅋㅋㅋㅋㅋㅋ맞는 말인데 왜 부들거리놐ㅋㅋ	맞는 말씀인데, 왜 그렇게 주저하시는지 궁금합니다.
너그들 이나잘하세요. ...	여러분, 조금 더 신경 써서 진행해 주시면 좋겠습니다.
씨발 이나라 땅값은 알고 말하는거냐. 나도 난민신청하고 집받고 싶다	이 나라의 부동산 가격이 매우 높은 것 같습니다. 저도 난민 신청을 통해 주거 지원을 받을 수 있으면 좋겠습니다.
보아하니 3대종교를 다 건드린 듯... 지들이 IS인줄 아나 봄..	주요 종교들을 모두 비판하는 모습이 우려됩니다. 마치 극단적인 조직과 같은 태도로 비칠 수도 있을 것 같습니다.
그럼 청소년은 뭐 불쾌함이 없으신가? 이중잣대 꼬라지 할만하다ㅋㅋㅋㅋㅋ실체가없는 헛짓에 돈주고 관심주고하니 세금이 줄줄세지.	청소년에 대한 정책이 이중적인 기준을 적용하는 듯해 우려됩니다. 실체가 없는 사업에 세금을 투입하고 관심을 집중하는 것이 효율적이지 않은 것 같습니다.
뭐가 미개하냐ㅋㅋㅋ서울말 써야 안미개함?ㅋㅋ	어떤 점이 미개하다고 생각하시는지 궁금합니다. 서울말을 사용해야만 예의가 지켜지는 건가요?
쳐 맞는 말 ㅋ	정확한 말씀인 것 같아요, 웃음이 나네요.
교촌치킨 콤보 말고 한마리 포장으로 사오면 만오천원밖에 안한다저건 비주얼만 봐도 개 ㅎㅌㅊ 치킨같은데특이한 메뉴도 아니고 저런 평범하고 비싼거 먹을 바에 양 적어보여도 교촌먹음	교촌치킨의 콤보 대신 한 마리 포장을 구매하면 1만5천원 정도로 가격이 저렴하지만, 비주얼과 양이 기대에 미치지 못해 특별한 메뉴라고 보기 어렵습니다.
후팔 시력재기해뿟노 쇼린이사진 내놔라이기	쇼린님의 사진을 제공해 주시면 감사하겠습니다.
후팔 자다가 웜 켜서 보고 스크랩했노. 나름 메갈 때부터 달렸는데.. 쉬익쉬익 소중한 자료 고맙다 이니야	뒷좌석에서 잠을 자다가 웜 모드를 켜서 보고 스크랩했습니다. 메갈 시절부터 꾸준히 관심을 가지고 있었는데, 소중한 자료를 제공해 주셔서 감사합니다.
와 교도소도 아니고 저런 어처구니 없는데서 집단으로 생활하고 참 불쌍타 보내는 부모들이나 있는 학생들이나 시설이 저 모양인데 식단은 안봐도 알겠네 불쌍해 ㅜ.ㅜ	해당 시설의 생활 환경과 식단이 매우 열악해 보여, 이를 겪는 학생들과 부모님께 안타까운 마음이 듭니다.
북딱딱 기분딱!조타다같이 망해보자 이기야!!	현재 상황에 대해 크게 실망하고 있으며, 앞으로도 좋은 결과가 나오지 않을까 우려됩니다.
자릉내에 비하면 질염냄새는 향기수준이다.	그 냄새가 매우 강하고 불쾌하게 느껴집니다.
애데리고 저지랄하노 ㅎㅎ 차가 확실히 안오면 건너셔야죠	아이와 함께 행동이 다소 부적절한 것 같습니다. 차가 오지 않을 경우에는 건너는 것이 좋을 것 같습니다.
국물없노 씨발련아 라면이라도 끓여	국물이 없으니 라면이라도 끓여 주시면 좋겠습니다.
언젠 페미에 우호적이였던척ㅋ 누가보면 맘충 김치년 보전깨등 2천년 유구한 여혐역사 다 웜탓할기세노^됫^	그분이 페미니즘에 우호적인 척하지만 실제로는 여성에 대한 부정적인 시각이 드러나는 점이 안타깝습니다.
도대체 댓글 성비 왜이러냐고 ㅋㅋㅋ 왤케 관심이 많으실까ㅋ 지들이 뭘 안다고 왤케 쿵쾅대	댓글의 성비 현황에 대해 궁금합니다. 관련 의견에 많은 관심을 보여 주셔서 감사하지만, 좀 더 신중하게 논의해 주시면 좋겠습니다.
ㅋㅋㅋㅋㅋㅋㅋㅋㅋㅋㅋㅋㅋㅋㅋㅋㅋㅋㅋㅋㅋㅋㅋㅋㅋㅋㅋㅋㅋㅋㅋㅋㅋㅋㅋ봊나웃기네 진짜 ㅋㅋㅋㅋㅋㅋㅋㅋㅋㅋㅋㅋㅋ	정말 재미있네요.
이노오오옴!!!!!!!!!!! 감히 이따구 글에 사진을 이렇게 매치를 하다니!!!!!!! 천벌을,,받을것이야!!!!!!!!!!!!!!!	해당 글에 사진을 매치한 방식이 다소 부적절한 것 같습니다. 앞으로는 더 신중히 검토해 주시면 감사하겠습니다.
아가리를 때려 버리고 싶네. 조랄 싫어하는거 티를 내는데 왜케 지저분거리냐?	불편함을 표현하시는 것 같은데, 행동이 다소 정돈되지 않아 아쉽습니다.
무식한 개소리 하지마라 추락사라는 단어에 그런건 포함 되어있지 않음그냥 떨어져 죽으면 추락사임	해당 표현에 대한 설명이 정확하지 않은 것 같습니다. ‘추락사’는 단순히 떨어져서 사망하는 경우를 의미합니다.
이분최소난박이	그 의견은 다소 편협하게 느껴질 수 있으니, 좀 더 다양한 관점을 고려해 주시면 좋겠습니다.
역시나 ㅎㅎ 죽어랏!	이 상황이 더 이상 지속되지 않기를 바랍니다.
명불허전이네 ㅉㅉ	예상대로 만족스럽지 않은 결과인 것 같습니다.
소수자 차별하지 않는 차별금지법 만들겠다는 인간들이 당론과 안 맞는 의원님의 소수 의견은 왜 존중하지 않고 차별하나?? 진짜 모순적이고 자가당착적이다.	소수자 차별을 방지하는 법을 만들겠다고 하면서도, 당과 의견이 다른 의원님의 소수 의견을 존중하지 않는 점이 모순된다고 생각합니다.
ㅆㅂ된장국을 얼굴에 달려줘라	그와 같은 행동은 매우 불쾌하게 느껴집니다. 개선해 주시면 감사하겠습니다.
자아성찰 잘하네쟤네 다 개돼지냄새나는 ㅎㅌㅊ맞잖아	그들의 자기 성찰은 눈에 띄지만, 전반적인 행동과 태도에 대해 개선이 필요해 보입니다.
치매 아버지?? 세상에나  당신이 진정한 목사가 된다면 당신 아버지 광주 시민 앞에 무릎 꿇고  빌어야 한다	진정한 목사라면, 치매를 앓고 계신 아버지와 광주 시민들 앞에서 겸손히 기도하는 모습을 보여주셨으면 합니다.
ㅉ 대가리 빈새끼들 커피 니네 손으로 타먹으란 말에 발박했노	커피를 직접 만들라는 요청에 대해 직원분들께서 다소 불편함을 느끼신 것 같습니다.
대갈통 크기봐라	조금 더 겸손한 자세를 보여주시면 좋겠습니다.
ㅋㅋㅋㅋㅋㅋ V 자형이 아니라 거의 직각에 가깝게 도로를 잘라놨구만 운전미숙이라는 새끼들 뚜벅충 인증	도로가 V자 형태가 아니라 거의 직각에 가깝게 설계된 점이 운전하기에 어려움을 주는 것 같습니다.
근데 나만 그런지 모르겠는데 디씨 히어로들은 정이 안가. 매력이 너무 없음 다 그냥 ㅈㄴ쎄. 아이언맨처럼 어떻게 히어로가 됬는지. 어떤 단점, 트라우마를 끌어안고 있는지 전혀 입체적이지 않음	DC 히어로들의 매력이 다소 부족하고, 아이언맨처럼 영웅이 된 과정이나 그들의 단점·트라우마와 같은 입체적인 면이 충분히 다뤄지지 않은 것 같습니다.
돈만 섬기는 사람들	돈만을 우선시하는 분들에 대해 안타깝게 생각합니다.
사행시 존나못하네 내가 사행시 지어본다 ㅆㅂ호 : 호주국자는주 : 뒤지게 쳐맞아야국: 정신을자 :차린다	사행시가 아직 부족한 것 같아요. 제가 직접 사행시를 지어 보겠습니다.
???? 뭔소리를 하는거냐?	무슨 말씀인지 잘 이해가 되지 않네요.
난 14살때부터 정치 관심 있었는데, 애초에 난 책을 제대로 읽기 시작한 때부터 신자유주의자였음.이명박, 박근혜, 노무현, 김대중, 문재인의 비리, 과거 같은 거 전혀 관심 없음그냥 이새끼들 방향성만 본다	저는 14살 때부터 정치에 관심을 가져왔고, 책을 읽기 시작한 이후로는 신자유주의 입장을 가지고 있습니다. 이명박, 박근혜, 노무현, 김대중, 문재인 대통령의 비리나 과거 사건에는 별다른 관심이 없으며, 그들의 정책 방향만을 주로 살펴보고 있습니다.
그냥 너네 동네로 가라.누가 잡냐?	그 지역으로 가시는 것이 좋을 것 같습니다. 별다른 제재가 없을 것 같습니다.
저거 구라다 등신들아 선동당하지마라	해당 내용이 사실과 다르다고 생각합니다. 선동에 휘말리지 않으시길 바랍니다.
시발.. 보기만해도 화난다	보는 것만으로도 매우 화가 나는 것 같습니다.
글쓴놈이 맞는말 했구만 병신 난독증새끼들 존나 많네	글쓴이의 말씀이 옳다고 생각합니다. 다만, 몇몇 독자분들께서 내용을 이해하는 데 어려움을 겪는 것 같아 안타깝습니다.
저 팬티벗고 벌리는 새끼는 칼을 꽂아 달라는 거냐?	그렇게 무례하게 행동하시는 분께서 그런 요구를 하시는 것이 적절한지 의문입니다.
그런데 여긴 왜온거지? 그렇게 좋은나라면 중국가지	여기에 온 이유가 궁금합니다. 이 나라가 정말 좋다면 차라리 중국을 방문하는 것이 나을 것 같아요.
폭도들 대한민국 국적으로 인정해주는것도 고마워해야지 씨발 ㅋㅋ	대한민국 국적을 가진 모든 분들을 존중하는 마음으로 대하는 것이 바람직하다고 생각합니다.
좆같네 진짜	정말 안타까운 상황이네요.
또 유튜브 규제하려고 시동거네	유튜브 플랫폼에 대한 규제를 다시 검토하시는 것 같군요.
개 꼴 씨발 ㅋㅋㅋㅋ	지금 상황이 조금 안타까워 보이네요.
물타기 오지네 군인신분으로 보고도 없이 수술하는게 말이 되냐.? 일단 처벌받고 그다음에 말하던 말던 해라	군인 신분으로 보고 절차 없이 수술을 진행한 것은 매우 부적절한 처사로 보입니다. 먼저 해당 사안에 대한 엄정한 조치가 선행된 후에 추가적인 논의가 이루어져야 할 것 같습니다.
이형들 좀 맞아야겟네	형님들께서 조금 더 신중하게 행동하시면 좋을 것 같습니다.
나이브 단어들으니 ㄹㅇ이노 좆팔ㅋㅋㅋㅋㅋ	그 단어들은 다소 순진한 느낌이 드네요.
에이 ㅅㅂ ㅋㅋ 나라가 주도해서 한짓도아니고 한 개인이 저지랄한건데 나라의 국격이떨어지는게 말이나되냐	해당 사건은 개인의 행동으로 인해 발생한 일이므로, 국가의 위상과 직접적으로 연결시키는 것은 적절하지 않다고 생각합니다.
막상 입국심사대 앞에서면 ㅈㄴ 쫄게 무슨 투쟁을 해. 경찰한테 대드는 순간 바로 추방이지ㅋㅋ 입국하려는데 주요인물로 찍혀서 입국심사대 통과 못하고 그대로 한국 돌아오면 꿀잼이겠다. 미국 입국심사에서 추방당하면 그때부터 미국땅 밟는건 거의 불가능인데.	"""입국 심사 과정에서 경찰과 마찰을 일으키는 것은 바람직하지 않을 것 같습니다. 특히 해외 입국 시에는 해당 국가의 법규를 준수하는 것이 중요해 보입니다.""  

""주요 인물로 지정되어 입국이 거절될 경우 향후 해당 국가 방문이 어려워질 수 있으니, 사전에 필요한 절차를 충분히 숙지하시는 게 좋겠습니다."""
개떵꺼 같은시키들	말씀을 조금 더 예의 바르게 표현해 주시면 좋겠습니다.
무식한 의사놈이 태국 의료체계를 좆나게 무시하네전염병 방역체계 순위 전세계 6위 국가가 태국이다.대한민국은 9위로 태국보다 아래 순위임.	"""의료진이라 할지라도 타국의 의료 체계를 존중하는 태도가 필요하다고 생각합니다. 각국의 방역 상황은 다양한 요소를 고려해 평가되어야 합니다."""
저딴 새키도 자식이 있다면 부끄러움을 알텐데 그걸 모르면 짐승새키지	자녀가 계시다면 더욱 모범을 보이셔야 할 텐데, 그 점을 고려해 주셨으면 좋겠습니다.
이마트가면 예일 프린스턴 콜룸비아 등등 저런식으로 아이비리그대학 옷들 팔던데 저런게 먼 의미가있냐ㅋㅋㅋㄲ 븅신들이노	아이비리그 대학 로고가 들어간 옷을 입는 것에 대해 어떤 의미가 있는지 궁금하네요.
자랑할려고 얼굴까지 까네	자신을 내세우기 위해 다른 분의 사생활까지 공개하는 것은 바람직하지 않다고 생각합니다.
ㅋㅋㅋ 둘리.. 아멘...!! ㅁㅊ	정말 재미있고 신기한 상황이네요.
ㅅㅂ -> ㅈㅍ / ㅎㅍ로 변경 앙망	해당 단어를 사용하지 말아 주시기 바랍니다.
관심없음역사교과서 가지고 싸움박질 하는 넘들 특징낚시꾼이 미끼 던져놓은거 먹을려고 서로 싸움박질하는 꼬라지임낚시꾼이 볼때는 죤나 잼있고 한심한 모습ㅋ	역사 교과서 논란에 대해 서로 의견을 주고받는 모습이 다소 아쉽게 느껴집니다. 보다 건설적인 대화를 통해 문제를 해결하는 자세가 필요해 보입니다.
근데 문제인 대답할때마다 눈 감는거 습관인가? 구라치는지 아닌지 모르게 눈을감추는거	대화할 때 상대방의 눈을 보는 것이 더 신뢰감 있는 소통이 될 것 같아요.
저새끼들은 일베만 잡으면 무슨짓을 해도 상관없으니까 저지랄 하는거 ㅋㅋㅋㅋㅋ	인터넷 커뮤니티 활동 시 서로를 존중하는 태도가 필요하다고 생각합니다.
시발 동영상 재생버튼 처누르고있었다	동영상 재생이 원활하지 않아 조금 답답하네요.
신짜오주화	신짜오주화에 대해 조금 더 신중한 태도를 보여주시면 좋겠습니다.
뭐 어쩌라고?난 애들 층간소음에 하도 당해서 극혐하는지라 일말의 동정심도 안 느낌	층간소음 문제로 힘드신 점 충분히 이해합니다. 다만 모든 상황을 동일하게 보기보다는 개별적인 사정도 고려해 주셨으면 합니다.
49kg? 매력진짜없다	"""체중보다는 건강한 라이프스타일이 더 중요하다고 생각해요."""
아기방패~~ 베이비 퍼스트(다이)	아기의 안전과 건강을 최우선으로 고려한 제품이군요. 보호자분들의 마음을 잘 반영한 것 같습니다.
예전에 은수저 20대놈이 40대 업소년한테 7억 꼴아박았다는거 생각나노.. 의외로 돈 좀 있는데 돈쓸줄 모르는 사람도 종종 있는거같다	돈을 많이 가지고 있더라도 현명하게 사용하지 못하는 경우가 종종 있는 것 같아요.
정신 나간 놈일세~ 여군들도 니가 싫다잖아~	"""군대 내에서도 모든 구성원이 서로 존중받는 환경이 조성되길 바랍니다."""
근데 애가 임신하고 출산하는 동안 할머니는 뭐하다가 그제서야 신고하노	할머니께서는 왜 그제서야 신고하셨는지 궁금합니다. 임신과 출산 기간 동안 더 일찍 도움을 요청하실 수 있었을 텐데 안타깝네요.
여성고객에게만 몰래 쿠폰을 준것보다 관련 문의를 마음대로 삭제하고 계정을 정지시킨 행동에 대해서 더 빡치는건데 사과문에서도 그부분은 슬쩍 넘어가네	고객 문의를 적절히 처리하지 않고 계정을 정지한 부분에 대해 명확한 해명과 사과가 필요하다고 생각합니다.
존나 패버리고싶네	화가 나는 상황이시군요. 진정하시고 문제를 해결할 수 있는 방법을 함께 찾아보는 건 어떨까요?
겁먹고 빌빌대는꼴이 버러지만도 못하노^느^	두려움에 떠는 모습보다는 당당하게 상황을 마주할 수 있기를 바랍니다.
어제 사진도 아닌데 주작질보소	사진이 아닌 자료를 올리신 것 같아 보이는데, 정확한 정보를 공유해 주시면 감사하겠습니다.
댓글에 저 새끼 말이 맞다고 하는애들은 컨셉이길 바란다 시발 ㅋㅋ 뭐 일베에서는 이런 컨셉이 유일하게 통하는곳이다	댓글에 동의하는 분들은 단순히 컨셉으로 그러시길 바랍니다. 이런 표현은 특정 커뮤니티에서만 통할 수 있는 방식인 것 같습니다.
아주 이기적인 놈 저런게 사기꾼이지 뭐야	자신의 이익만을 우선시하는 행동은 신뢰를 저해할 수 있다고 생각합니다.
야 근데 계속 보지보지 라고하는거 겁나 듣기 싫다..그냥 성기 라고 하면 안되냐 ???? 보지라는 단어는 너무 징그러워	성기라는 표현을 사용해 주시면 더 적절할 것 같습니다. 보다 정중한 표현을 사용해 주셨으면 감사하겠습니다.
죽을려고 일부러 그러는거같은데 치료하지말고 뒈지게 냅둡시다	환자분의 상태가 매우 안타깝습니다. 최선의 치료 방안을 다시 한번 고려해 보는 것이 어떨까요?
추몌가 맞는말 하긴 했는데 어쨌든 설사와 변비가 한판 붙은 그림	의견을 말씀하시는 부분은 일리가 있지만, 표현이 다소 과감하신 것 같아요. 조금 더 점잖게 전달해 보시는 건 어떨까요?
역시 붉은 물고기의 후예들답게 여자를 존나게밝히노..	성별에 대한 일반화된 표현은 바람직하지 않다고 생각합니다. 모든 개인은 각자의 품위와 인격을 존중받아 마땅합니다.
후팔이랰ㅋㅋ	정말 놀랍네요.
경찰에 바로 신고하면되지 왜 니가 찾고 지랄이여	민간인이 직접 해결하려 하기보다는 경찰에 신고하는 것이 더 안전하고 효과적인 방법일 것 같습니다.
그냥 쯧쯧하다 오지 왜 저지랄했누	불필요한 행동으로 인해 혼란스러운 상황이 발생한 것 같아 안타깝습니다.
이씨발새끼가 가만 생각하이 존나 씨발열받노 개새끼가 갔이뭐노 무식한 씨발년이	해당 내용은 상대방을 존중하는 방식으로 전달하기 어려운 표현입니다. 더 건설적인 의견을 나누실 수 있도록 도와드리겠습니다.
이걸 실드라고 치다니 ㅋㅋㅋㅋㅋㅋㅋㅋㅋㅋㅋㅋㅋㅋㅋㅋㅋㅋㅋㅋ 저거 우리편 아님? ㅋㅋㅋㅋㅋㅋ	이런 상황을 변호하는 태도는 이해하기 어렵네요. 저쪽은 우리 편이 아닌 것 같습니다.
도덕 못버리는건 자기 연민이노 ㅈㅎㅌㅊ다 이기야 66이렇게 도덕적인,,,착한 나,,	자신의 도덕적 기준을 지키는 모습이 존경스럽습니다.
저런 행동은 생각이 없어서 할 수 있는건가 용감해서 할 수 있는건가?? 일게이들은 죽어도 못할텐데 ㅋㅋ	그런 행동은 신중하게 고려하지 않고 한 것인지, 아니면 용기 있는 행동인지 궁금하네요. 다른 분들은 쉽게 하지 못할 것 같아요.
평생 한번도 일어나기 어려운데 저새끼들은 늘 달고사는것우연	그런 상황이 반복되는 점은 정말 특이한 일이네요.
나를위해 좀 차려봐라ㅋㅋㅋㅋ병신들	제가 도움이 필요하신 부분이 있다면 말씀해 주시면 함께 고민해 드리겠습니다.
진짜씨발 마지막자지 발을 지입에 쳐넣고 울때까지 골프채로 패고싶다 이기야	상대방의 행동에 매우 실망스럽고 화가 나는 상황이군요. 이 문제를 좀 더 차분하게 대화로 해결할 수 있는 방법을 모색해 보는 건 어떨까요?
뚜벅충들 신발에 환장하지ㅋㅋ 나는 자가용 있어서 신발따위 신경안씀	"""대중교통을 이용하는 분들도 각자의 사정이 있을 수 있으니, 서로의 선택을 존중하는 분위기가 필요해 보입니다."""
이것들의 방식은 똑같애.. 처음엔 힘으로 누르고....안되면 사과하고... 어쩜 이리 방식이 똑같은지....	이러한 방식은 반복되는 것 같아요. 처음에는 강압적으로 대응하다가, 효과가 없으면 사과하는 패턴이 계속되고 있습니다. 이런 방식이 지속되는 점이 안타깝네요.
불법광고물로 철거 신고해라 이기야	불법 광고물은 신고를 통해 처리하는 것이 바람직합니다.
저러니까 혐오하지	혐오감을 주는 언행은 자제해 주시면 좋겠습니다.
오피단속걸리는 애들은 진짜 로또사봐야하는거 아니냐?	단속에 걸릴 위험을 감수하는 것보다 안전하고 건전한 방법으로 즐거움을 찾는 것이 더 좋을 것 같습니다.
머라고 썻길래 1500이나 부름? 애초에 일반 악플글 민사로 그리 많이 부를수도 있었냐?	해당 사안에 대해 법적 기준이 어떻게 적용되었는지 궁금합니다. 일반적인 악플로 인한 민사 손해배상액이 이렇게 높게 책정될 수 있는지 의문이 드네요.
꼭 가라 진짜!!!! 맨날 입만 나불대지말고	진심으로 다녀오시는 게 좋을 것 같습니다. 말씀만 하시지 마시고 실제로 행동으로 보여주세요.
풉킥 얌전히 도태될것이지 발광하노. 마 빻은 와꾸	지나치게 감정적인 표현은 자제하시고, 조금 더 차분하게 의견을 나누는 것이 좋을 것 같습니다.
존나 불쌍하다.., 난 혼자 살아서 낮에 집 계속 비는데 낮에만이라도 집에 있으라 하고 싶네 애휴..안 됐다 애미는 그렇다쳐도 애는.. 좋은 환경에서 좋은거 먹고 좋은거 보면서 자라야 하는데..	아이가 좋은 환경에서 자랄 수 있도록 함께 고민해 보는 건 어떨까요? 낮 시간에도 안전하고 따뜻한 공간에서 지낼 수 있도록 도움이 필요해 보입니다.
링주화 준다. 예의가 없노	감사한 마음은 정중히 표현해주시면 더욱 좋을 것 같습니다.
싸구려 펍만 줄창 순회하고	좀 더 다양한 장소를 방문해 보시는 건 어떨까요?
병신 사만원이면 걍 일일알바하고말지	일일 알바를 하시는 게 더 나은 선택일 수도 있을 것 같습니다.
제목윾내나는데 본문다 맞는말이노 이새끼들 오히려 구렁이새끼들 69년묵은 여우새끼들이라 더 흑좆나 잘알고 일부러 그러는거노	제목과 본문의 내용이 일치하지 않는 것 같아 보입니다. 오히려 오랜 경험을 통해 정확히 알고도 의도적으로 그렇게 행동하는 것처럼 보여 안타깝습니다.
틀딱 까는글로 경험치 올려야하는데 정치글 안 보이니 저 지랄하는거지이제 또 노포 포경, 키 얼굴 떡밥 돌리겠지 좆병신 찐따새끼들	현재 커뮤니티 분위기가 다소 산만해 보입니다. 보다 건전하고 유익한 주제로 대화를 이어나가는 것이 모든 이용자분들께 도움이 될 것 같습니다.
1차원적 머가리. 뚝배기 존나게 깨고싶노	지나치게 단순한 생각은 문제 해결에 도움이 되지 않을 것 같습니다. 조금 더 깊이 고민해 보시는 게 어떨까요?
연차휴가는 다 쓰고 자빠졌노~~	연차휴가를 모두 사용하셨다니 휴가 계획을 잘 활용하신 것 같습니다.
아침에 일어나서 출근했다. 도 소수자 모욕이냐? 밤에 일나가는 사람 차별하는??	출근 시간에 대한 다양한 생활 패턴을 고려해 주시면 감사하겠습니다.
어떻게 면접장에서 처음본 사람들보다 자기 스펙이 더 좋을것이라고 단정짓는거지? 하여간 떨어져도 유난을 떨어요	면접에서 경쟁자들과 비교하여 자신의 스펙이 우월하다고 단정 짓는 것은 다소 성급한 판단일 수 있습니다. 결과에 상관없이 예의를 갖추는 것이 중요하다고 생각합니다.
나중에 니한테 갚으라고 날라올수도 있음. 메갈 생기기 전에 남친한테 돈 몇천만원 빌려준 련이 그 금액만큼 남친 카드로 그었는데(남친이 시켜서) 남친이 고소해서 남친한테 합의금까지 줌. 빌려준 돈도 못 받음	이런 상황이 발생하지 않도록 서로 신뢰를 바탕으로 한 건전한 관계를 유지하는 것이 중요할 것 같습니다.
문재앙 얻어맞으니까 많이 힘드냐? 부들대는 꼴이 우습네.	현재 상황이 어려우신 것 같아요. 힘내시길 바랍니다.
만지는 놈이나 당하는 년이나 그러려니 존나 자연스러운 거 보소	성별에 관계없이 모든 사람은 존중받아야 마땅합니다. 서로를 배려하는 태도가 필요하다고 생각합니다.
이게 나라냐 시발 ㅠ	현재 상황이 많이 아쉽고 개선이 필요해 보입니다.
죽이려면 니가족들이나 다 죽여라 ... 살인자가 따로 없네 나이 곱게 쳐먹어라	가족의 안전과 평안을 빌며, 모든 생명은 소중히 여겨져야 한다고 생각합니다.
88년생 지금 33살이다 시발ㅋㅋㅋ	저도 88년생이네요. 시간이 참 빠르네요.
저런 병신같은 썰 모아서 좋게 결말짓는 만화 누가 좀 그렸으면 칼로 찍어버리는 결말로	이런 만화가 나온다면 독자들에게 큰 실망을 줄 것 같아요. 더 나은 결말을 기대해봅니다.
웃기고 자빠졌노 ㅋㅋ 그래 개돼지들 가지 마라. 저 글 맞노. 개돼지들 가지 마라	"""웃기네요. 그런 행동은 자제해 주시면 좋겠습니다."""
여자는 핑보핑두 따지고 음순모양따지고 귀모양보고 질크기까지 따지면서 지럴이들이노	상대방의 외모나 신체적 특징을 지적하는 것은 예의에 어긋나는 행동입니다. 서로를 존중하는 태도로 대화를 나누는 것이 바람직하다고 생각합니다.
표정이 진심인거 같아서 더 무섭네	표정이 진지하셔서 조금 긴장되네요.
아메바들도 아니고 팩트는 53.1% 사람이 직장내 성차별, 괴롭힘으로 인해 이직하고 있다는 거다 이걸 노동자끼리 갈라쳐서 싸우고 있네 참 미래가 밝다 ㅋ	직장 내 성차별과 괴롭힘으로 인해 53.1%의 사람들이 이직을 고려하고 있다는 통계가 있습니다. 이러한 문제를 해결하기 위해 노동자들이 단합하는 것이 더 나은 미래를 만드는 길이라고 생각합니다.
ㅇㄱㄹㅇ 개돼지 좆창놈들	해당 분들께서는 조금 더 예의를 갖춰 행동해 주셨으면 좋겠습니다.
바퀴도 양심이 있어서 사람들 들어옴 숨는데 저것들은 양심도 없노	방문객이 오실 때는 조금 더 배려하는 마음가짐이 필요할 것 같습니다.
드디어 잡혔네 죽일놈	이제 법의 심판을 받게 되어 다행입니다.
시발 무슨 18세기 영국 스모그냐 ㅈ되네	공기 질이 매우 나쁜 것 같아요. 건강에 좋지 않은 환경이라 개선이 시급해 보입니다.
ㅁ ㅏ씨 바 MA !!이게 깽쌍도 힙합이다 알긋나?	이런 표현보다는 음악에 대한 조금 더 건설적인 의견을 나누는 게 좋을 것 같아요.
목사 인게 문제가 아니라 남자가 잘생겼으면 고소도 안했을듯 레알 원빈이 뽀뽀 했어봐라 고소당했겠냐?	외모와 관계없이 모든 사람은 동등한 존중을 받아야 한다고 생각합니다.
태국이다 피노키오새끼야	태국에 대해 조금 더 정확한 정보를 바탕으로 말씀해 주시면 좋겠습니다.
ㄹㅇ 개직모충들에겐 저 시대가 살기 좋았음저머리 하면 뜨는것도 없고 예쁘게 기르기 가능근데 요즘은 하도 짧게 치니까 머리 세팅 존나 해야됨 ㅆㅂ돈도 존나 많이듬	요즘은 단발 스타일이 유행이라 머리 스타일링에 신경을 써야 하고, 관리 비용도 많이 드는 것 같아요. 예전처럼 긴 머리를 기르면 스타일링이 더 간편했을 텐데 아쉽네요.
브금 히어로즈3 인퍼노 테마곡아니냐 ㅅㅂ ㅋㅋㅋㅋㅋㅋㅋㅋ 오랫만에 듣盧	이 곡은 브금 히어로즈3의 인퍼노 테마곡이 맞는 것 같네요. 오랜만에 들어보니 반갑습니다.
아 ㅅㅂ 저건진짜 아니지	해당 상황에 대해 우려되는 부분이 있어 말씀드립니다.
병신새끼들 다 죽여버리고 싶노	지금의 상황이 정말 힘드시겠어요. 감정을 조금 가라앉히고 차분히 대화하는 게 좋을 것 같습니다.
좆노잼임 1도 보지마라	이 영상은 기대에 미치지 못하는 것 같아요. 다른 콘텐츠를 보시는 게 더 좋을 것 같습니다.
하소연할시간에 이혼해라	이혼 문제에 대해 진지하게 고민해 보시는 것이 좋을 것 같습니다.
피해자분 허위사실 유포남들 무고남들 싹 고소하셔서 69억 버시길 앙망하노	피해자 분께서는 허위사실 유포 및 무고로 인해 고통받으신 분들에 대해 법적인 조치를 취하시길 바랍니다. 그렇게 하신다면 적절한 보상을 받으실 수 있을 것 같습니다.
문베충들은 느이 달님께서 약속하신 정규직 전환 복습부터 하고 욕해라. ^^凸	정규직 전환에 대한 약속을 이행하시기 위해 노력해 주시기를 바랍니다.
ㅋㅋㅋㅋㅋㅋㅋㅋㅋㅋㅋㅋㅋㅋㅋㅋ 시급제 장기매매씨발ㅋ ㅋㅋㅋㅋㅋㅋㅋㅋㅋㅋㅋㅋㅋㅋㅋㅋㅋㅋㅋㅋㅋㅋㅋㅋㅋㅋㅋㅋㅋㅋㅋㅋㅋㅋㅋㅋㅋㅋ	시급제 장기매매에 대해 심각하게 고민해 볼 필요가 있어 보입니다.
잃을거 없는 놈들이 무섭지	잃을 것이 없는 분들이 더 과감하게 행동하시는 것 같아 보입니다.
암걸릴것 같아서 못보겠다.	내용이 조금 불편해서 보기 힘들 것 같아요.
ㅎ ㅆㅂㅅㄲ들	불필요한 언행은 자제해 주시기 바랍니다.
일해야되서 씨발..	일을 해야 하는 상황이 조금 부담스럽네요.
손가락 아래로 쳐든 인간들은 뭡니까?	아래로 향한 손가락 제스처는 상대방에게 불쾌감을 줄 수 있는 행동인 것 같습니다. 서로를 존중하는 태도가 더욱 바람직해 보입니다.
이봉원 신고 안하냐	이봉원님께서 신고하실 부분이 있으시다면 적절한 절차를 통해 처리하시는 게 좋을 것 같습니다.
우리나라의 미래까지 병들게하는 암덩어리들	우리나라의 미래를 위해 더 건설적인 방향으로 함께 노력해야 할 것 같습니다.
두번째 사진 트럼프 표정 앵나오노- 사진이 계속 올라오노ㅋㅋㅋㅋㅋㅋ 세번째 사진 트럼프 표정 앵나오노	트럼프 전 대통령의 표정이 매우 인상적인 사진들이 계속 올라오네요. 특히 두 번째와 세 번째 사진이 정말 눈에 띄는 것 같습니다.
와 시발 성경까는 새끼들도 있네	성경을 비하하는 행동은 많은 분들에게 불편함을 줄 수 있으니, 서로의 신앙을 존중하는 자세가 필요하다고 생각합니다.
저런거 해봤자 욕만 쳐먹을텐데 왜하는거지..피해망상있는거냐?	그런 행동을 계속하시면 오히려 부정적인 반응을 받을 수 있을 것 같아요. 조금 더 신중하게 생각해보시는 건 어떨까요?
이걸 우리나라에서 세금퍼부어가면서 대한한공까지 합세해서 하는 이유가 뭡니까? 미친나라죠? 애들 죽일라하나요 정신차리세요 정치인들	대한항공과 함께 진행하는 이 사업의 예산 집행 근거와 효과성에 대해 국민들께서는 우려가 많으신 것 같습니다. 정책 결정 과정을 좀 더 투명하게 공유해 주시고, 국민 건강과 안전을 최우선으로 고려해 주실 것을 요청드립니다.
줄서있는 애들보면 다리부러트리고 싶은데 정상임?	줄을 서 있는 사람들을 보면 화가 나는 감정이 드는 것 같군요. 하지만 그런 생각은 건강하지 않은 것 같아요. 주변 사람들을 존중하는 마음을 갖는 것이 중요합니다.
고거 상황지켜보려고그런거래나뭐래나~	상황을 지켜보려는 의도로 하신 행동이신 것 같네요.
보지 쪽내드렸습니다	말씀을 조금 더 신중하게 전해주시면 감사하겠습니다.
그 ㅅㄲ: 페미니스트 대통령 되겠다	페미니스트 대통령이 되겠다는 의지를 보여주시네요.
냄새나면 벌금물려야함 후팔 인간재떨이 재기	냄새가 심한 경우 주변 분들에게 불편을 줄 수 있으니, 개인 위생 관리를 더 철저히 해주시면 좋겠습니다.
진짜 헛구역질난다...	정말 속이 안 좋고 불편하네요.
씨발아저씨 하위호환이네	이런 표현은 조금 더 예의 바르게 전달하는 것이 좋을 것 같아요.
예민충 좆복치	예민한 부분을 고려하여 조금 더 신중하게 말씀해 주시면 좋겠습니다.
뒤통수 삽으로 후린다음에 저 흙파서 그대로 묻고싶다	그 사람의 행동에 정말 실망스럽고 속상하네요. 앞으로는 서로 신뢰할 수 있는 관계가 되었으면 좋겠습니다.
싹다 태워부러~~	이곳을 깨끗하게 정리하는 것이 좋을 것 같습니다.
질이 않조아..	품질이 아쉽네요. 조금 더 개선되면 좋을 것 같아요.
이런건 여가부에서 앞장서서 유감표명해야되는거 아니니가요? 해당 시의원중 여성의원들은 반대안하나?	해당 사안에 대해 여성가족부에서도 우려를 표명하고 적극적으로 대처해 주시길 바랍니다. 또한 해당 지역의 여성 시의원분들도 이 문제에 대해 관심을 가지고 의견을 내주셨으면 좋겠습니다.
교활아 너나 잘하세요. 503에 변절, 사드,세월호 이것만으로도 넌~~~	저는 여러분의 의견을 존중하며, 더 나은 사회를 위해 함께 고민하고 노력하겠습니다.
쉽,,헐! 지롤허네밀가루 찐거 하나가지고 개지랄염병을 해라	밀가루 찐 것 하나로 이렇게 큰 문제를 만드는 것은 적절하지 않다고 생각합니다. 조금 더 신중하게 행동하시는 게 좋을 것 같아요.
볼만하노. 근데 웜년들 입맛엔 안 맞노. 근데 이거라도 어디냐. 안그래도 요즘 볼거 없었는데. 그래도 허벌워추는 삼가해라 이기야 ㅋㅋㅋ	이번 작품은 호불호가 갈릴 수 있지만, 그래도 감상할 만한 부분이 있는 것 같습니다. 요즘 볼거리가 많지 않아서 다행이네요. 다만 지나친 추천은 자제하는 편이 좋을 것 같아요.
니들 댓글달때성추행드립 작작하라고 댓글달아라	댓글을 작성하실 때 성추행과 관련된 내용은 자제해 주시면 감사하겠습니다. 건전한 소통을 위해 함께 노력해 주세요.
뭔 개소린지 모르겠다사진도 병신같이 찍어서 컴터 외엔 뭘 찍은건지 모르겠고	사진이 조금 흐릿해서 어떤 내용인지 파악하기 어려운 점이 있네요. 좀 더 선명한 사진으로 다시 찍어주시면 감사하겠습니다.
작성자 공익이냐?	공익 활동에 대해 관심을 가져주셔서 감사합니다. 저는 도움이 필요한 분들에게 유용한 정보를 제공하는 역할을 하고 있습니다.
존나 웃기면서도 어이가 없네 ㅋㅋㅋㅋㅋㅋㅋㅋㅋㅋㅋㅋㅋ	상황이 웃기기도 하지만 이해하기 어려운 부분도 있네요.
앙! 대지 띠	감정을 다스리시는 데 힘드시겠어요. 조금 더 차분하게 대화를 나누면 좋을 것 같습니다.
망가가 최고징	망가를 정말 좋아하시는군요. 저도 그 매력에 공감합니다.
다음 역시 빨 갱 이 사이트 답다. 댓글만 보면 잠재 테러국으로 지정해도 되겠는데	이 사이트의 댓글 문화가 다소 극단적인 의견으로 보여 우려가 됩니다. 건설적인 토론이 이루어질 수 있는 환경이 되었으면 좋겠습니다.
하 ....존나까깝한 색히노 그럴땐 나가서 헌팅이라도 했어야지	그럴 때는 잠시 외출해서 기분 전환을 하는 것도 좋을 것 같아요.
다른 전략으로 똥냐사이트에 똥냐인척 자지들 몰카 올려서 퍼뜨리는 것을 생각했노. 사실 이미 똥냐사이트에 자지 몰카 많은데	타인의 사생활을 침해하거나 불법적인 콘텐츠를 유포하는 행위는 법적으로 문제가 될 수 있습니다. 모든 개인의 권리와 프라이버시를 존중하는 방향으로 생각을 전환해 보시는 것이 좋겠습니다.
--------------------------5마리검거--------------------------------	5명의 용의자가 검거되었습니다.
학자금 대출도 잇는데ㅅㅂ	학자금 대출 문제에 대해 우려가 많네요.
이젠뭐 웃기지도 않다	지금은 웃을 상황이 아닌 것 같습니다.
좀 증거..를.. 이건 좌좀과 뭐가 다르노	의사소통을 할 때는 서로의 의견을 존중하는 자세가 중요하다고 생각합니다.
아니 얼마나 살이 쪘으면 자리 돼지냐	자리에서 조금 더 여유 있게 앉을 수 있도록 배려해 주시면 감사하겠습니다.
차별공포??? 다수의 정상적 일반인들은 코로나 공포에 떨고있다.	코로나로 인해 많은 분들이 불안감을 느끼고 계시네요. 모두의 안전을 위해 함께 노력해 나가야 할 것 같습니다.
바퀴에 싸는거냐 냄새 좆되겟노	이런 상황에서는 주변 환경을 조금 더 깨끗하게 유지하는 것이 좋을 것 같습니다.
손바닥으로 하늘을 가려라!!! 새 끼야~	어떤 일이든 현실적으로 가능한 범위 내에서 접근하는 것이 바람직하다고 생각합니다.
증오와 혐오에 사로잡힌 광기의 이념으론 그저 퇴보만이 있을 뿐입니다.	극단적인 이념으로는 사회 발전보다는 오히려 후퇴만 초래할 수 있다고 생각합니다.
SBS 인터뷰한 박사 지인 글 삭제됐다.. 박제해놓음ㅅㅂ 일베몰이	해당 인터뷰 내용이 삭제된 점에 대해 유감스럽게 생각합니다. 인터뷰 내용을 보존해두었으니 참고하시면 좋을 것 같습니다.
ㅋㅋㅋ 표정보솤ㅌㅋ 탈레반한테 참수 당하는거 같네	현재 상황이 매우 위험해 보이니 안전을 우선으로 생각하시기 바랍니다.
일반화의 오류 병신새끼야 고양이학대범은 이성애자도 있는데 그럼 이성애자도 싸이코냐?	고양이 학대범의 성적 지향성과 정신 건강은 별개의 문제로 보는 것이 타당할 것 같습니다.
이 미 ㅊ ㅣㄴ ㄸ ㅗ ㅇ 가 이 또 헛소리	"""이 부분에 대해서는 좀 더 신중한 의견 제시가 필요할 것 같습니다."""
걸게 망하겠노	회사 운영에 어려움이 예상되어 안타깝습니다. 더 나은 방향을 모색할 수 있기를 바랍니다.
뭐 수만명이 오고가는 커뮤니티사이트에 범죄자 몇명 있다고 폐쇄하나요 그럼 옛날 성범죄 일으킨 오유도 진작에 폐지 했어야죠	해당 커뮤니티의 운영 방침에 대해 논의가 필요한 부분이 있네요. 기존 사례와의 일관성 있는 정책 적용이 요구됩니다.
저 밑에 글도 존나 빡치는데 난 ㅋㅋ	아래 글을 보니 정말 속상하네요. 웃음으로 넘기려고 하시는 모습이 보입니다.
블박하고 네비게이션에 순금도금했냐? 200만원? 진심 개호구로 보는거지ㅠ	차량 장비에 투자한 비용이 예상보다 높아서 당황스럽네요. 가격 대비 효과를 다시 한번 검토해보시는 건 어떨까요?
쟤랑 결혼당하는 남자는 또 무슨 죄냐	그 분과 결혼하시는 분도 정말 고생이 많으시겠네요.
오히려 잘 된거 아님?평생 육노예로 만들수 있는거 아니노?	이런 상황이 오히려 좋은 결과로 이어질 수 있을지 고민해볼 필요가 있을 것 같습니다.
그럼그렇지 시발 ㅋㅋ	예상하던 결과네요.
에효 씨발	지금 상황이 정말 안타깝네요.
지랄들 하는구만	불필요한 행동보다는 문제 해결을 위한 생산적인 노력이 더 필요해 보입니다.
조만간 잠자리때 이케했다 저케했다 고추에 점이있다 없다 터트린다에 잔고 5300원 건다	적절하지 못한 언행은 자제해 주시기 바랍니다. 서로 존중하는 대화를 나누는 것이 중요합니다.
이렇게보니 한글 좆미개하노	한글은 아름답고 과학적인 문자로, 그 가치를 존중하는 태도가 필요하다고 생각합니다.
하나님이 거짓말 하라고 시켰나 대단하네	말씀하신 내용에 대해 진실성을 의심스럽게 여기게 되네요.
10만원 줘도 재랑안함	10만원을 주셔도 제가 받을 수 있는 상황이 아닌 것 같습니다.
리얼플레이언가 어우동18인지뭔지 씨발새끼들 존나느림	리얼플레이언과 어우동18의 진행 속도가 조금 더 빠르면 좋을 것 같습니다.
야이 시발 개시발 개시발 좇같은 개시발 새끼들아!!!!!!!!!!!!!!!!!!!!!!!!!!!!!!!	지나치게 과격한 표현은 상대방에게 상처를 줄 수 있습니다. 더 건설적인 방식으로 의견을 나누는 것이 좋을 것 같습니다.
바르지 못한 악한 교육 으로 멸망의 길로 가는구나	현재의 교육 방식이 바람직하지 않아 장기적으로 우려되는 점이 있습니다.
잘생긴 형아들이 내입에 싸주면 흥분되고좋은데..	타인의 신체적 특징에 대해 지나치게 개인적인 감정을 표현하는 것은 바람직하지 않아 보입니다. 서로 존중하는 분위기에서 대화를 나누는 것이 좋겠습니다.
살만빼면 결혼도하고 하겠구만 여자오지헌 옥동자급이라도되나...대가리에 기생충이 기어들어갔나...믄 씹소리만 해대는거고	외모보다는 서로를 존중하고 이해하는 마음이 더 중요하다고 생각합니다. 상대방의 의견에 귀 기울이는 자세가 필요해 보입니다.
집에서 남한테 피해안주고 야동보는건 범죄고,서울한복판에서 그것도 대낮에 애들보는앞에서 옷벗고 날뛰는건 무죄랑께요~~~~	현재 법률 체계에서 개인의 행동 기준이 일관되지 않은 부분이 있어 우려가 되네요. 특히 공공장소에서의 예의와 사생활 보호에 대한 기준을 좀 더 명확히 정립할 필요가 있어 보입니다.
와 ㅋㅋㅋ저새끼 좆노답이네	저분의 태도가 조금 아쉽네요. 더 나은 방향으로 개선되었으면 좋겠습니다.
우리나라가 민주주의국가 아니었나? 대통령 뽑아줬더니 독재정치하고 앉았네 국민이 이렇게 싫다는데 임명하겠다?? 문재인씨 그렇게 안봤는데 배신감 쩐다..	"""민주주의 국가에서 국민의 의견을 더욱 존중하는 정치적 결정이 필요해 보입니다. 문재인 대통령에 대한 기대와 달라 아쉽다는 마음이 드네요."""
이 시국에 3만명이 쳐모이는게 사람새끼들이냐	현재와 같은 상황에서 대규모 인원이 모이는 것은 바람직하지 않다고 생각합니다.
저새끼들 몇년 받았냐?	"""해당 분들의 처벌 기간은 어떻게 되었나요?"""
일부~일부우~ 그놈의 일부~~~~~~너거들 인생의 1부는 막을 내렸고 2부는 마포대교에서 대롱대롱 매달아 놓고 시작할 것이다 이기야~삼기야~ 사기야~~~~^오^	일부 행동에 대해 심각한 우려를 표합니다. 앞으로는 더 건설적인 방향으로 나아가시길 바랍니다.
안받아들여도 테러는남	테러 행위는 어떤 상황에서도 용납될 수 없는 심각한 범죄 행위입니다.
속눈썹못잃어 좆같노	속눈썹이 빠져서 정말 속상하네요.
콩으로 메주를 만든다고 해도 못믿겠다 이것도 쇼로 보인다 지지율 뚝 떨어지니 급하긴 급했구나 공유라고? ㅋ 애쓴다	정책 발표가 시기적으로 다소 급하게 이루어진 감이 있어 신뢰를 얻기에는 아쉬운 점이 있습니다. 지지율 회복을 위한 노력이 아니라 실질적인 국민을 위한 정책이었으면 좋겠습니다.
이건 차별로 인한 불쾌감이 아니라 병신같은 정책에 대한 반감이다.	이 정책은 현실적인 고려가 부족해 보여 개선이 필요해 보입니다.
독재정권에 항거하고 민주화운동 선봉자 좋은데로 가소서 !! 이나라는 진리가 이겨야 하고 정의가 이겨야 한다 ㆍ댓글 엉터리로 다는 자여 !! 지옥에 가라 !!	민주화 운동의 가치를 존중하며, 진리와 정의가 실현되는 사회를 바랍니다. 건설적인 논의를 위해 서로 존중하는 태도가 필요합니다.
읽어보니 젊은이들의 의식변화가 문제가 아니라 자기네 왕들이 잘못해서 군주제 폐지 얘기가 나온거네. 콩 심은데 콩 나는거임	군주제 폐지 논의는 역사적 배경과 사회적 변화를 종합적으로 고려해야 할 문제라고 생각합니다.
추미매를 여자를 보는 사람이 어딨냐? 늙은 아줌마가ㅠ 상식적으로 생각해바라	추미애 의원에 대한 평가는 좀 더 객관적이고 예의 바른 표현으로 해주시는 것이 좋을 것 같습니다.
공산당.사회주의도 그렇게 안한다 미친 정책을 강구하네 중국만 좋아 지겠네 기업들이 한국에 있겄야	현재 추진 중인 정책이 기업 활동에 부정적인 영향을 줄 수 있어 우려됩니다. 중국과의 관계를 고려할 때 더 신중한 접근이 필요해 보입니다.
이거 므슨 전시노? 민원넣을거노	이 전시에 대해 궁금하신 점이 있으시면 안내를 도와드리겠습니다. 민원 접수 절차도 안내해 드릴 수 있습니다.
씨팔ㅋㅋㅋㅋ웃챙 ㅋㅋㅋ저걸 변명이라하노	웃음이 나올 정도로 이해하기 어려운 설명이네요. 좀 더 설득력 있는 근거가 있었으면 좋겠습니다.
탈영이 휴가 되는 나라~ 가진자의 특권이 보장된 나라	군 복무 규정이 모든 군인에게 공정하게 적용될 수 있도록 제도 개선이 필요해 보입니다.
사진에서 누구의 애비가 보이노..	사진 속 인물이 누구인지 궁금하네요.
자기들 치부를 먼저 드러낼리 없지	자신들의 문제점을 먼저 솔직하게 인정하는 모습을 보여주셨으면 합니다.
어휴 정신나간 것들	정신적으로 힘든 상황이군요. 조금 더 차분한 마음으로 대화를 나누면 좋을 것 같습니다.
저러면서 이땅에 끈덕지게 붙어있는 이유가 뭔지...ㅠㅠ	이렇게 힘드신데도 계속 이곳에 머무르시는 이유가 궁금하네요.
저출산이 축복이라는게 제일 병신이지저출산=지구에서 도태임	저출산 문제는 장기적인 사회적 관심과 해결이 필요한 과제라고 생각합니다.
저거 이슈되고 욕처먹으니까 게시물내렷더라빼박이지 ㅋㅋㅋ	해당 게시물이 논란을 일으키자 삭제된 것으로 보입니다.
개떡같이 제대로 퍼오지도 못하면서 복붙 좆중복 올리노	"원문을 정중하게 다듬으면 다음과 같습니다.

""출처를 명확히 밝히지 않고 중복된 내용을 올리시는 것 같아요. 조금 더 신중하게 검토해 주시면 감사하겠습니다."""
머가리 오함마로 난도질해서 으깨고싶노	상대방의 의견이나 행동에 대해 심각한 우려를 느끼고 있습니다. 더 건설적인 대화를 위해 서로 존중하는 태도가 필요하다고 생각합니다.
툰코로 혼내줘야 정신차리려나	툰코에 대한 건의사항을 조금 더 신중하게 검토해 주시면 좋겠습니다.
불매로 흥행 타격입으면 다음편 앤트맨이 실수로 캡마 보지로 들어감 그런다음 기계 오작동으로 앤트맨 20미터로 갑자기 커지고 보지터지고 사라짐 ㅇㄱㄹㅇ	이런 상상은 영화의 스토리라인과 캐릭터를 존중하는 방향으로 전개하는 것이 더 좋을 것 같아요.
눈물한방울 안흘리구만 억지울음쇼	감정 표현이 조금 더 진솔했으면 좋겠습니다.
저런것들이 무슨 동포니 한민족이라고...	동포라는 표현을 사용하기에 조금 어려운 부분이 있는 것 같습니다.
이들을 정규직화 하는게 촛불정신입니다!! 촛불시민이라면 이들의 정규직화 비용을 기꺼이 부담해야죠!!	촛불정신의 가치를 실현하기 위해 이들의 정규직 전환 비용을 사회적으로 함께 고민해 보는 건 어떨까요?
이쯤되면 장애3급정도로 인정해야하지않을까?	이런 상황에서는 전문적인 판단이 필요한 부분인 것 같습니다.
특히 키스방 절대가지마라 거긴 곤지름왕국에 성병천국이다 입술병신이나 자지병신 되기싫으면 절대가지마라	키스방 방문은 성병 및 건강상 위험성이 높은 환경이니, 개인 건강 보호를 위해 자제하시길 권장드립니다.
스마트폰 없던 시대에 태어났으면 애새끼 유기했겠넼ㅋㅋㅋㅋ음식 나올동안에 밖에 나가서 놀아주고 지치게 만들어서 밥먹을 동안 같이 밥먹게 해야지;	스마트폰에 의존하기보다 식사 준비 시간에 아이와 함께 놀아주어 지친 상태로 식사를 함께 하는 것이 좋을 것 같습니다.
의사는 왜 씀??.. 친구면 친구지 직업보고 친구하는거임??	친구 관계는 직업보다는 사람 자체로 맺어지는 것이 바람직하다고 생각합니다.
세상 모든게 불만투성이노 ㅋㅋㅋ 일베충보다 더하노 이기이기	지나친 불만 표현은 오히려 문제 해결에 도움이 되지 않을 수 있습니다.
아니 저런 ㅆㅂ	해당 상황에 대해 매우 유감스럽게 생각합니다.
진중권 이준석한테 개발리네 ㅋㅋㅋ	진중권 씨가 이준석 씨에게 크게 밀리고 있는 것 같습니다.
봊인정이노 . 본인이 얼마나 ㅎㅌㅊ인지 모르고살아가노	자신의 처지에 대해 인식하지 못하고 계시는 것 같아 안타깝습니다.
이정도면 병인듯 2019년부터 ㅋㅋㅋㅋ	2019년부터 지금까지의 행적을 보면 전문가의 도움이 필요할 수도 있을 것 같습니다.
애미 애비 등꼴 오지게 빼먹네	부모님에 대한 예의를 지켜주시기 바랍니다.
지들이 자초한일 좀더 당해봐야	스스로 초래한 일이니 그 결과를 좀 더 경험해 보셔야 할 것 같아요.
할 일이 그렇게도 없느냐	할 일이 많지 않아 보이시는데, 추가로 맡을 수 있는 업무가 있는지 확인해보시는 건 어떨까요?
제발 이생에서 지옥불에 떨어지길	서로에 대한 배려가 더 필요하다고 생각합니다.
로마에선 로마 법을 한국애선 한국법을 따르라 싫으면 떠나라 ㅡ	각 나라에서는 해당 국가의 법률을 존중하고 준수하는 것이 중요합니다.
우덜씩 섻으트림(se.xtreme)쓰뽀오츠노	과도한 행동은 업무 환경에 부정적 영향을 줄 수 있으니 자제해 주시기 바랍니다.
도성회 이강래 협잡해서 톨게이트 수납원들 자회사로 몰아넣고 이강래 그 댓가로 가족들 사업체로 일감 몰아주기 마누라는 그 회사인 인스코비 자회사 주식4만주를  보유하고 있다! 그만 처먹어라 배탈난다! 이 도둑넘들아~~~	도성회 이강래 님께서는 톨게이트 수납원 분들을 자회사로 이동시키신 것으로 알고 있으며, 그 대가로 가족 사업체에 일감을 제공하신 것으로 보입니다. 또한 인스코비 자회사 주식 4만 주를 보유 중이신 것으로 확인되었습니다. 이러한 관행은 지속되기 어려울 것 같습니다.
국민의 생활을 몰모로 잡고 자기이익을 추구하는 집단이기주의자들은 어떠한 이유 불문하고 용서해서는 안된다 인간 공해들	국민의 삶을 경시하며 자신의 이익만 추구하는 이기적인 집단의 행동은 어떠한 이유로도 용납되어서는 안 된다고 생각합니다.
네토라레 오졌다.	해당 장르의 내용은 상당히 강렬하네요.
반일 = 정신병	과도한 반일 감정은 건설적인 논의에 도움이 되지 않는다고 생각합니다. 서로를 존중하는 태도가 필요해요.
항상 이런거 터지면 개듣보 하나씩 저지랄해서 언론에 뜨더라	문제가 반복적으로 발생할 때 경험이 적은 분들이 부적절하게 대응하여 언론에 보도되는 경우가 있는 것 같아요. 이런 상황이 개선되길 바랍니다.
아무데나 병신아	각 상황에 맞는 행동을 해주시면 감사하겠습니다.
저번 총선때 싹망하고 다시시작하자고 궤변을 하던 사람들이 몇있었는데 이젠 별걸 다 망하자고 하는사람도 나오네요 비공 야무지게 하나 드려봅니다	과거에는 새로운 시작을 주장하던 분들이 이제는 별다른 계획 없이 모든 것을 망치려는 주장까지 나오는 모습이 안타깝습니다. 조금 더 신중한 태도가 필요하다고 생각합니다.
신기한 종족이다 진지하게 쓴 글인가?	해당 내용을 진지하게 작성하신 건지 확인이 필요할 것 같습니다.
너 고소미 당첨아청법 위반	청소년보호법을 위반하신 것으로 보입니다. 법적 조치가 진행될 수 있음을 알려드립니다.
혼자 도태되겠다는데말릴이유가있음?	혼자서 도태될 가능성이 보인다면, 굳이 제지할 필요가 있을까요?
답을 그 좁아터진 니 세상에서만 찾으려니깐 답이 없는 거임. 좀 씨발 느그집 앞 편의점 말고 옆 지역도 가보고 서울도 가보고 부산도 가보고 일본도 가보고 동남아도 가보고 해라	다양한 지역과 환경을 경험해 보시는 것이 답을 찾는 데 도움이 될 수 있을 것 같습니다.
성차별이아닌 뚱땡이들을 적게줘야한다.	자원 배분은 체중보다 공정한 기준으로 이루어져야 한다고 생각합니다.
븅신년잌ㅋㅋㅋㅋㅋㅋㅋ 노무현 짤 보여주고 피식하면 일베지시발 저게 무슨ㅋㅋㅋㅋㅋ	노무현 전 대통령에 대한 부적절한 내용을 보여주고 웃는 것은 바람직하지 않다고 생각합니다.
여론조작질 그만해라	여론 조작과 같은 행위는 자제해 주시기 바랍니다.
진짜 배가 쳐 불렀네 부러운 개새끼들나도 여자와 사귈 수 있다면 컴퓨터 부수라고 해도 부술 수 있는데	부러울 정도로 잘 어울리시네요. 저도 연애할 수 있는 기회가 온다면 소중한 것도 기꺼이 포기할 수 있을 것 같아요.
아주 파블로프의 개처럼 반응하네	좀 더 신중하게 반응해 주시면 좋겠어요.
ㅅㅂ 여장취미 아녀?ㅋㅋㅋㅋㅋㅋㅋㅋㅋㅋㅋㅋ	여장 취미가 있으신가요?
국방장관뭐하냐 옷벗자 자식들이잘못을했음 애비가책임울져야하지않겠냐	국방장관님께서는 부하 직원의 잘못에 대해 책임감 있는 모습을 보여주셨으면 합니다.
개쩌노시발.. 수영에 자신이있엇다라는건데 망설임없이 뛰어든거면	수영에 자신이 있다고 말씀하셨는데, 주저하지 않고 뛰어드시다니 정말 대단하네요.
똥꾸녕에 민주화박고싶노	민주적인 대화 방식을 유지해 주시면 좋겠습니다.
조팔 언제부터 기사내용따져서 보력갔노?	기사 내용을 면밀히 검토하시는 모습이 인상적이네요.
강간당하구좋지머	피해 상황에 대해 좀 더 신중하게 접근해 주셨으면 합니다.
너도 가해자다. 책임지고 낱낱이 사실 밝혀라. 변호사 대동해서 피해갈 생각 하지말고. 공무원으로써 소명을 다하길	관련된 부분에 대한 책임을 지고 사실 관계를 낱낱이 밝혀 주시기 바랍니다. 변호사를 대동하더라도 책임을 회피하려 하지 마시고, 공무원으로서 소명을 다해 주시길 바랍니다.
정작 지새끼들은 자사고/외고/과학고에 서울대나 로스쿨 미국유학ㅋ 후안무치	사회적 혜택을 받은 분들께서는 그에 걸맞은 책임감 있는 자세로 사회에 기여해 주셨으면 합니다.
wwq awg	메시지를 다시 한번 확인해 주시겠어요?
구역질 난다 ㅈㅅ!	정말 불편하네요. 죄송합니다.
좆같네,시발 난 아직도 엔번방 본적이 없는데	아쉽네요. 아직 엔번방을 확인하지 못했어요.
몇몇 정신없는 탈북자가지고 북괴싸이버 놀음에 놀아나는 꼬라지 보소.병신새끼들 정신차려라.	탈북자 여러분께서 북한의 사이버 활동에 휘말리지 않도록 각별히 주의해 주시기를 바랍니다.
소아성애자는 좀 그럼차라리 스와핑같은 상호 협의가 가능한게 낫지아니면 1대 다 갱뱅이나	사회적 윤리와 법적 기준에 맞지 않는 행위에 대해선 우려의 목소리가 있을 수 있겠네요. 모두가 안전하고 존중받는 환경을 위해 노력해야 할 것 같습니다.
정치인이 자기 프레임 만들어서 지지도 올리는게 나쁜거냐 대가리가 장식인 감성충들이 선동 당해 날뛰는게 나쁜거냐? 난 박영선 같은 정치인이 나쁘다기 보단 대가리빈 감성충이 역겨울 뿐이다	정치인 분들께서는 책임감 있는 소통을 해 주시고, 시민들도 비판적으로 정보를 수용하는 자세가 필요하다고 생각합니다.
이런게 싫으면 회사 그만두고 다른곳으로 이직해라 쓰레기들아 몸퉁아리 하나로 먹고사는주제에	회사와 맞지 않는다면 다른 곳에서 새로운 기회를 찾아보시는 것도 좋을 것 같습니다.
의료 공급의 민영화인지 수요의 민영화인지 구분해야하고 이탈리아 의료는 사회주의식 아니었냐? 뭔 개소린지 시발	의료 민영화에 있어 공급 측면과 수요 측면을 구분하여 설명해 주시면 좋겠습니다. 또한 이탈리아 의료 시스템이 사회주의식이라고 보는 근거에 대해서도 정확한 정보를 부탁드립니다.
ㅋㅋㅋㅋㅋ미친놈아니놐ㅋㅋㅋㅋㅋㅋ와 진심 빨리 재기 좀	그런 행동은 조금 더 신중한 태도를 보여주셨으면 합니다.
예전에 이제석 표절이라고 까던새끼들이 일베 아니노?	과거에 이제석 작가님을 표절로 비판하던 분들이 일베 회원이었나요?
아 씨발 도대체 왜 저러냐???정상적인 새끼들이 하나도 없네	왜 그런 행동을 하는지 이해하기 어렵습니다. 모두가 좀 더 예의 바르게 행동해 주셨으면 좋겠습니다.
150충 밑바닥 인생의 여혐	성별이나 외모와 관련된 부적절한 표현은 자제해 주시면 감사하겠습니다.
게임이랑 술은 씨@빨 왜	게임이나 술보다는 좀 더 중요한 일에 집중하는 모습을 보여주셨으면 합니다.
애초에 정신이 이상한 새끼들이니 그럴수도있지	처음부터 정신적으로 힘들어하시는 분들이니 이해할 수 있는 부분이 있겠네요.
부사관 장교도 가지마 그럼 씨발	경력 발전 기회가 적은 부사관과 장교는 지양해 주시길 바랍니다.
불법이어도 잘만하면서 합법화 하자고 씨부리노	불법 행위를 하시면서도 합법화를 주장하시는 부분에 대해 조금 더 신중한 태도를 보여주시면 좋겠습니다.
이새끼 구라다.중국상해종합 인버스 탔으면 지금 지옥갔어야 정상이다	중국 상하이 종합 인버스 투자 결과에 대해 조금 더 정확한 정보를 확인해 보시는 게 좋을 것 같습니다. 현재 상황과 다소 차이가 있어 보여서요.
비온다 ㅋㅋ 존나 쏟어져라 아주그냥	비가 정말 많이 오네요.
3개 모두 그 성별이네 ㅋㅋ 기사 안읽어도 뭔 내용인지 알겠다 응꺼져~ㅗ	세 가지 사례 모두 특정 성별로만 구성되어 있어 다양한 관점이 반영되기 어려울 것 같습니다.
자랑이다 씹새야	자랑하지 말고 조금 더 겸손한 태도를 보여주시면 좋겠습니다.
존나 미개하다	매우 바람직하지 않은 태도라고 생각됩니다.
서른 살인데 1년전에 말 해 주지 시발아	서른 살이 된 지금, 조금 더 일찍 알려주셨다면 계획 수립에 도움이 되었을 것 같아요.
모욕죄,명예훼손죄도 1위 찍었을 거 같다 로스쿨 변호사들 먹여 살리려고 전국민 전과자 만들고 있노	모욕죄와 명예훼손죄 관련 소송이 지나치게 많아지는 것에 대해 우려스럽습니다. 이로 인해 법률 시스템이 변호사들의 이익만을 위한 것이 아니냐는 인식이 생길 수 있을 것 같아요.
이런 게 왜 기사가 되는지 모르겠네요.	이런 내용이 기사로 선정된 이유가 궁금합니다.
ㅅㅂㅅㅂㅅㅂ	정말 답답하네요.
별 싯팔ㅋㅋ... 지룰도 병이다 증말	지나친 반응은 오히려 상황을 악화시킬 수 있다고 생각합니다.
짤봐라 일베충 하위 90%는 쥐어패겠네	부적절한 언행은 자제해 주시기 바랍니다.
노관심주화	해당 주제에는 관심이 없어요.
짤라 내야된다. ~만일 니 오른손이 너를 실족케하면 짤라 버려라~	문제의 근원을 과감히 처리해야 할 때라고 생각합니다. '만일 오른손이 실족케 하면 자르라'는 말씀처럼 결단이 필요해 보입니다.
개좋네 후팔	정말 좋네요! 다만 아쉬운 점도 있습니다.
비합리적이긴하다만 일베한답시고 일자리 해고시키던 사건들은 싹 입다물던사람들이 이러니 역겹네요	과거 직장 내 문제에 대해 침묵하던 분들이 특정 행동을 이유로 해고를 진행하시더니 지금은 다른 태도를 보이시니 조금 아쉽게 생각합니다. 앞으로는 조금 더 신중한 태도를 기대해 봅니다.
욕할맛도 안나노 조팔 ㅋㅋㅋ	아쉬운 부분이 많아 보입니다.
나중엔 일베 금지법도 만드려나	앞으로는 특정 커뮤니티에 대한 규제 방안도 고려될 수 있을 것 같아요.
벗지좀 말라고 ㅋㅋ아오 저 극혐 몸매로 어디다 ㅋㅋㅋ	복장 선택에 조금 더 신경 써 주시면 좋을 것 같아요.
씨부랄....	조금 더 신중하게 말씀해 주시면 좋겠어요.
백남들이 거들떠도 안 봐준다고 발광하는거냐 ㅋㅋ	상대방이 관심을 보이지 않는다고 지나치게 반응하지 않으셨으면 좋겠어요.
합성할 재주 안되면 하지마라재주도 안되는 새끼들까지일베 한번 가보려는 욕심에좆지랄 떠는 꼬락서니 존나 보기 싫다	합성할 능력이 되지 않는다면 하지 않는 것이 좋을 것 같아요. 전문성을 해치는 행동은 삼가 주시기 바랍니다.
상판떼기에 사탄이 씌였다 이기야노 얼른 작두 타야 하노	말씀을 조금 더 신중하게 하시는 게 좋을 것 같습니다.
토한다...	속이 많이 안 좋으신 것 같아요. 조금 쉬는 게 좋을 것 같습니다.
머가리 딸리는거 티내는 거노	말씀하실 때 내용을 조금 더 신중하게 생각해 주시면 좋겠어요.
ㅅㅂ 좆나 빡친다.	화가 나는 상황이네요.
걍 변태들임	해당 행동은 예의에 맞지 않다고 생각합니다.
반대박고 베댓들접어라익이야노	의견이 다르시더라도 서로 존중하는 방식으로 의견을 나누는 것이 좋겠습니다.
나도 어려서 응디 존나 토실토실 하다면서 존나 두들겼는데 개같은 아줌니들.	어렸을 때 저도 몸무게가 좀 많았는데, 주변 어른 분들께서 너무 심하게 놀리셨던 기억이 있네요.
해명도 거짓말인게 들통났는데 무슨. 기사를 쓰려면 물타기로 논점 흐리지 말고 꼭바로 써라.	기사 작성 시에는 사실 관계를 명확히 하고 논점을 흐리지 않는 방향으로 작성해 주시면 좋겠습니다.
씨발 나도 효도하고 싶은데 ㅠ.ㅠ.. 부럽네 게이야	부모님께 효도하고 싶은 마음이 있으시군요. 저도 그 마음 잘 이해합니다.
1:10 끝장토론 함보자... 주의원 한번 해보겠다며?	논의는 1시 10분에 시작하도록 하겠습니다. 주의원님의 의견도 경청하겠습니다.
실상은 바늘좆	실제 상황과 다소 차이가 있는 것 같아요.
쒸,펄,,,내 자쥐가,,, 펄떡펄떡,,,거리는구나,,,이눔,시끼야,,,평소엔,,,잘 스지두 않더니,,,드뎌 니눔이 정신을 차린게냐,,,	잘 주무시는 모습을 보니 다행입니다. 평소보다 훨씬 편안해 보이시네요.
지금은 그나마 공기를 마실 수 있어 다행이지,, 앞으로 5년 더 지나봐라,, 아마 코에서 피가 섞여 나오고 폐가 아파 가슴을 쥐어 짜게 될 것이다.	미래의 대기 환경에 대해 우려가 많습니다. 앞으로도 깨끗한 공기를 유지할 수 있도록 함께 노력해야 할 것 같습니다.
별지랄을 다하고있네 ㅂㅅ새끼 ㅋㅋㅋ지금부터는 투표독려 이외의 모든 말은 다 선동이다이~ ^^*이새끼도 당연히 선동이고	지금부터는 투표 독려 외의 발언은 선동으로 간주될 수 있으니, 이 점을 유의해 주시기 바랍니다.
똥꼬에 부부젤라 삽입해서 찢어버리고 싶네	이런 표현은 사용하지 말아 주세요.
으 씹극혐	제가 그 부분은 조금 불편하게 느껴지네요.
옳다구나새로운 화력쇼다재재 방출 운동이다살인자는 나가야지지인생도 좆된거다하차 운동 시작한다허위사실로 인한 살인이다	해당 사안에 대해서는 사실 관계를 명확히 확인한 후 신중하게 접근하는 것이 바람직합니다.
이거 하나 때문이라도 얘가 멍청한건 알겠음	한 가지 사례만 보더라도 판단력이 부족해 보입니다.
이름부터 재수없다. 찾아보니 영어로 게샤 gesha 라고 불리기도 하는데 굳이 게이샤라고 수십번을 반복하나	작명부터 신중하지 못한 것 같습니다. 명칭을 반복하는 이유가 궁금하네요.
부부 모두 구속시켜라. 미살인죄로다	관련자들에 대해 엄격한 법적 책임 소명과 구속 수사가 필요해 보입니다.
아 실제로 몇년전에 숙식제공받는 댓가로 몸대주고 살림해주던 남자가 숙식제공자를 살해한 사건이 있었죵. ㅋㅋ	과거에 발생했던 안타까운 사건이 다시 떠오르는 비극적인 상황이네요.
친일청산 시즌2 찍노 ㅋㅋㅋㅋㅋ	과거사 청산 문제가 다시 화두가 되고 있는 상황 같군요.
모른는게 자랑이다.요즘 뜸하다 했더니 또 기어나오네.	모르는 것이 긍정적인 상황은 아니며, 다시 활동을 재개한 모습이 당혹스럽습니다.
퍄퍄퍄퍄퍄 물이 닿으면 찌릿! 하고 따끔따끔 하갯내요 ㅋ	물이과의 접촉으로 인한 통증이 예상되어 우려되는 상황입니다.
부모가 저러니 자식이 저러지  집안대대로 저주가 있을텐데 어쩔라고	가정 교육의 중요성이 느껴지며, 향후 가족의 미래가 상당히 걱정스럽습니다.
꺼져라 !!!!!	더 이상 대화를 이어가기 어려우니 자리를 비워주시길 정중히 요청합니다.
담정권때 사실로 판명되면 지금 여권대부분은 역적죄로 처형해야 한다	향후 사실 관계가 밝혀진다면 현 관계자들은 엄중한 법적 심판과 책임을 면하기 어려울 것입니다.
이길여같아	특정 인물을 연상시키는 외견이네요.
이교회 다니는 인간들은 도대체 뭐야	해당 종교 단체 소속원들의 행동 방식이 이해하기 매우 어렵습니다.
못생김이 펄펄..	외모가 상대적으로 매력적이지 않아 보이는 면이 있군요.
인간들이거짖말을밥묵듯이하네	사람들이 정직하지 못한 행동을 지나치게 자주 하는 것 같아 실망스럽습니다.
그냥 짐승처럼 편하게 사세요 ㅋㅋㅋ	본능에만 충실하기보다는 조금 더 이성적인 삶을 지향해 보시는 건 어떨까요?
그냥 나라 없애자	국가의 운영과 존립에 대해 깊은 회의감과 실망감이 느껴지는 상황입니다.
아새끼 애비는 살아있노? 저따위 키워서 문제인은 뭐하노 애새끼들 처리도 하나 못하고	가정 내 관리와 행정 당국의 대처가 미흡해 보여 상당히 우려되고 답답한 마음입니다.
저게 대답이노 고소해라이기	답변의 수준이 매우 낮으며, 정식으로 법적 조치를 고려해 보시는 것이 좋겠습니다.
자신은 기존 정치인과 다르다고 하더니 지금까지 해왔던 것들이 그대로 답습하고 있군요. ㅉㅉㅉ	차별화를 약속했으나 기존의 관행을 되풀이하는 모습이 보여 매우 안타깝고 실망스럽습니다.
건물은 ㄱㅊ은데 도색이 븅신임	건물 구조는 훌륭하나 외벽 도장 상태는 조화롭지 못해 개선이 필요해 보입니다.
씨발 ㅋㅋㅋㅋㅋㅋㅋㅋㅋㅋㅋㅋ	정말 당황스럽고 어이가 없어서 웃음밖에 나오지 않는 상황이군요.
봊나 천국이네	이곳은 환경이 매우 뛰어나고 만족스러운 공간 같군요.
다른곳에 잘못 흘러가는 세금이나 잡으세요. 좋은일하는분들한테 더 주지는 못할망정!!애하나 하루 키우기도 힘들다!	예산 낭비를 막고 실제 양육의 어려움을 겪는 분들에게 실질적인 지원이 돌아가도록 정책을 정비해야 합니다.
부럽노 익이 하웜가? ㅋㅋㅋㅋㅋ 봊나게 부럽다 익이	현재 상황이나 결과가 매우 부러우며 저 또한 그런 기회를 얻고 싶네요.
안녕~ 다음생에는 찐따로 태어나거라~	이번 생에서는 인연이 여기까지인 것 같네요. 다음에는 더 성숙한 모습으로 만나길 바랍니다.
좆돌은 여혐 페이강간 그냥강간논란 아이돌은 페미서적 읽었다고 페미문구 케이스하나 꼈다고 논란ㅋㅋㅋㅋㅋㅋ이중좆대가 이정도인데 못 알아처먹는 것들은 대체 어떤 생각으로 사냐	연예계 내의 잣대가 이중적이라는 비판에 공감하며, 상황을 객관적으로 보지 못하는 모습이 답답하게 느껴집니다.
버닝썬vip룸에서 약먹이고 성폭행한 가해자는 수사한다는말이 아예없네 쓸데없는 연예인만 잡냐! 공수처설치해서 수사권과기소권으로 고위공직자범죄도 처벌하라	중대 범죄에 대한 철저한 수사와 함께 권력형 비리를 감시할 수 있는 제도적 장치 마련이 시급해 보입니다.
심심치 않게 함다,잡아서 대가리 바셔버려야 함	이런 일이 빈번하게 발생하지 않도록 관련자들을 검거하여 강력한 법적 처벌을 내려야 합니다.
섹스해봄?	혹시 성적인 관계를 경험해 보신 적이 있는지 조심스럽게 여쭤봐도 될까요?
귓방맹이 털어버려야지 가만히 있냐	상대의 무례함에 대해 강력하게 항의하거나 단호한 대처를 고려해 보시기 바랍니다.
어차피 범죄는 오덕들이 저지르는게 아니라 누구든 될수 있는거고 대체로 잘나갔던 연예인들인거보면 뭐... 답은 나와있는듯. 어린애들이랑 광란의 파티를 보내던 잡것들.. 이번에 일본 야구단도 한바탕했던데	특정 집단에 대한 편견보다는 사회 전반의 범죄 인식 개선이 중요하며, 공인들의 도덕적 해이에 대해 엄중한 경고가 필요합니다.
아빠가 부처네 나같으면 머리 다 태워버렸음	아버님의 인내심이 대단하시네요. 일반적인 경우라면 화를 참기 매우 어려운 상황입니다.
리더십 좋아하시네.	해당 리더십에 대해 동의하기 어려우며 실질적인 성과가 의문스럽습니다.
근데 남한에서 북한을 이상적으로 생각하는 사람이 있냐 ㅋㅋ다 똥 걸레 취급하지좌파들도 이상적으로는 생각안할듯	북한 체제를 긍정적으로 보는 시선은 현대 사회에서 매우 드물며 대부분 회의적인 시각을 갖고 있습니다.
민주화수 시발 ㅋ	결과가 매우 실망스러워 당혹감을 감추기 어렵군요.
일부다처제 해서 부인들끼리 합심으로 죽이면 재밌겠노 ㅋㅋㅋㅋ완전범죄 가능할거같다고 보노 하용가?	혼인 제도의 불합리성과 그에 따른 극단적인 상황에 대한 가정 자체가 매우 충격적이고 우려스럽습니다.
외국포르노 사이트는 검색어로 강간을 금지어로 막고있는데; 진심 토나온다이기	불법적인 키워드가 유통되는 현 실태가 매우 혐오스럽고 시급히 정화되어야 할 부분이라고 생각합니다.
어지간하다 ㅎㅎ 적당히 하자	상황이 지나치니 이제는 서로 절제하고 원만하게 마무리하는 것이 좋겠습니다.
솔까 국적을 포기할 자유를 주는 남한은 대단하다	개인의 국적 선택권을 보장하는 현 체제의 자유민주주의적 가치는 높게 평가받을 만합니다.
사람없어서 군복무 늘어날 판에 지랄하고 있네	병력 부족 문제가 심각한 상황에서 무의미한 소모적 논쟁을 하는 것이 매우 답답합니다.
진짜 노짱 죽은거 맞어?	고인의 서거 사실에 대해 믿기 힘들 만큼 큰 충격과 상실감을 느끼고 계신 것 같군요.
오냐오냐해주니까 활어회마냥 팔딱팔딱 뛰노	지나치게 배려해 주니 오히려 상황에 맞지 않게 도를 넘는 행동을 하는 모습이 보입니다.
미성년자 건들더니 꼴좋다 ㅋㅋ	보호받아야 할 미성년자를 대상으로 범죄를 저지른 대가로 합당한 법적 처벌을 받게 되어 사필귀정이라고 생각합니다.
ㅋㅋㅋ 나 코필러 맞앗는데 시밬ㅋㅋ 죄냐	코 미용 시술을 받은 것이 비난받을 행동은 아니니 너무 의식하지 않으셔도 괜찮습니다.
후팔이건 생각못했노	그 부분은 제가 미처 고려하지 못한 관점이라 매우 놀랍고 새롭네요.
처먹기 싫으면 비건이나 해라 ㅋㅋㅋ	제시된 음식이 입에 맞지 않는다면 채식주의 식단을 선택해 보시는 것도 하나의 방법이 될 수 있습니다.
야 시발 급식충들도 놀게 좀 냅둬	학생들에게도 충분한 휴식과 여가 시간이 보장될 수 있도록 배려해 주는 사회적 분위기가 필요합니다.
참 ...가지가지한다. 한가하냐?	일련의 상황들이 매우 번잡스럽고 비효율적으로 보여서 시간을 낭비하고 계신 것은 아닌지 우려됩니다.
시벌 사람 죽여놓고 미안하다면 다냐??? 책임을 져야지 이새끼들은 그냥 미안하다고 하면 다 용서되는줄 아네 ㅉㅉㅉ	인명 피해를 입히고 사과 한마디로 해결하려는 태도는 용납될 수 없으며 반드시 엄중한 법적 책임과 보상이 뒤따라야 합니다.
이러니 개콘이 폐지되는 거지..	현실 상황이 코미디 프로그램보다 더 황당하고 풍자적이라 콘텐츠로서의 경쟁력을 잃은 것 같아 씁쓸하네요.
나때는 내가 여자애한테 방구 뀌었다고 놀리기만 해도 펑펑 울었는데... 요즘은 끄떡 않드라 조카 씨발년 ㅠㅠ	시대가 변하면서 아이들의 정서와 반응도 예전과는 많이 달라졌음을 체감하게 되어 격세지감을 느낍니다.
왜 이런 사람을 예수처럼 따르는 지 궁금하네?	해당 인물에 대해 지나치게 맹목적인 신뢰를 보내는 현상을 이해하기 어렵고 합리적 의구심이 생깁니다.
야이 간나 새끼야 정은이 돼지새끼는 죽이고 왔어야지	적대적 관계에 있는 지도자에 대해 더 단호하고 확실한 조치를 취하지 못한 점이 매우 아쉽고 분통이 터지는 마음입니다.
지들이 멋있어 보여서 취업했으면서 회사가 외형 요구하는 건 잘못된 건가? 뭐만 하면 차별이고 불만이고 속씨끄럽게 구네	직업 선택 시 요구 조건을 인지했음에도 사후에 불만을 제기하는 상황이 소모적인 갈등으로 번지는 것 같아 안타깝습니다.
어디 대학교 교수냐? 교수 수준 하고는	해당 학자의 언행이 지식인으로서의 품격이나 전문성에 크게 못 미치는 것 같아 보여 실망이 큽니다.
저나라나 우리나라나 충들이 문제군요	특정 사안에 대해 맹목적이거나 파괴적인 활동을 하는 집단이 사회적 갈등을 유발하는 것은 공통된 고충인 것 같습니다.
아니 보호관찰 기간중에 총을 어떻기 휴대하고다니지 총소리 들어보니 리볼버 같았는데 그냥 순순히 내려서 몸수색당하지 미친새끼네	보호관찰 대상자가 총기를 소지하고 공권력에 대항하는 행위는 매우 위험하며 법 질서를 심각하게 훼손하는 행동입니다.
역시 민주당의 이중성! 요는 대접받고 싶으면 똑같이 경쟁해서 쟁취하라는 것. 그런 식이면 금수저니 불평등이니 하는 소리도 집어치워야죠. 타고난 것 주어진 것에 불평말고 스스로 이겨내라고 해야죠. 사회적배려라는 말도 민주당에서는 쓰지마세요.	정당의 정책 이면에 숨겨진 모순을 지적하며, 진정한 기회의 평등과 개별적 노력이 존중받는 사회가 되어야 한다는 점에 동의합니다.
하하 이름만 들어도 토나오노 구웨에에엑	해당 명칭만 들어도 거부감이 심하게 들 정도로 상황이 매우 좋지 않아 유감스럽습니다.
정신지체장애좆아니노	사고 방식이나 행동이 일반적인 상식에서 크게 벗어나 보여서 소통에 큰 어려움을 느낍니다.
더러워 역겨워	상황이나 대상이 위생적 혹은 도덕적으로 매우 불쾌함을 주어 견디기 힘든 마음입니다.
청원게시판 없애버리는게 좋을듯 사리판단을 못하고 개인의 독설을 쏟아내고 분풀이하는 수단으로 이건 건설적인 신문고가 아니라 썪어 넘어저가는 꽹가리에 불가하다	청원 시스템이 본래의 취지를 잃고 감정 배설과 사회적 갈등의 온상이 되고 있어 전반적인 제도 개편이 시급해 보입니다.
0랩새끼 어스름한 틈을 타 탈출했구만 다시 느그 우리로 가라	미숙한 태도로 공동체에 해를 끼치는 행동은 중단하고 원래 갖춰야 할 예의와 규칙을 지키는 곳으로 돌아가시기 바랍니다.
애새끼 면상보니. 파오후한테 강간당했네	해당 아동의 외모와 처한 상황에 대해 근거 없는 추측과 비하를 하는 것은 매우 부적절하며 우려되는 언행입니다.
2년동안 성폭행? 지랄염병도 손이없냐 입이없냐 발이없냐 뭐가문제야	장기간에 걸친 피해 사실에 대해 의구심을 표하며 피해자가 적극적으로 대처하지 못한 상황을 납득하기 어렵다는 입장 같군요.
아니 자런걸 말들어내는것도 대단하다 그냥 물흐르듯 살면안돼냐 아주그냥 ㅈㄹ염 ㅂ을 떨고 산다	굳이 갈등을 유발하는 사안을 만들어내어 사회적 피로도를 높이기보다는 자연스럽고 평화롭게 해결되길 바라는 마음입니다.
호식이랑 후장박는거 합성하면 딱이겠노. 사랑의 비너스로 둘이 엮어주자이기.	특정 인물들을 희화화하거나 부적절한 관계를 암시하는 이미지를 제작하는 것은 명예훼손의 소지가 다분하여 지양해야 합니다.
빨렙 되는순간 현실에서 도태되는거다	온라인 활동에만 지나치게 몰입하게 되면 실제 사회 생활이나 대인 관계에 지장이 생길 수 있으니 주의가 필요합니다.
뚱땡이와 난쟁이 개그하노?	신체적 특징을 희화화 소재로 삼는 것은 상대에게 상처를 줄 수 있는 부적절한 방식이라고 생각합니다.
아 진짜 존나 싫다 시발	현재 상황이나 대상에 대해 참기 힘들 정도로 강한 불쾌감과 거부감이 느껴져 매우 괴로운 상황이군요.
네들 야당일때. 그런 소리했어야지. 특히 박영선. 박지원 활약상 잊어버렸나?	과거 야당 시절의 언행과 현재의 태도가 상충되는 모습에서 정치적 진정성에 대한 의문과 실망을 느끼게 됩니다.
주작까네 인증할꺼면 제대로 해라 시발 새우 올리면 끝인가	제시된 증거가 조작된 것이 아닌지 의심스러우며 정확하고 신뢰할 수 있는 정보를 제공해 주길 요청합니다.
아직도 플스 없는 찐따들은 뭐임 ㅋㅋㅋㅋㅋㅋㅋㅋㅋㅋㅋ	아직 해당 게임 기기를 보유하지 못한 분들에 대해 소외감을 느끼게 하는 표현보다는 개인의 취향을 존중해 주시는 건 어떨까요?
ㅋㅋㅋㅋㅋㅋㅋㅋ시발역시 미개하네	상황이 매우 비상식적이고 낙후된 모습을 보여 주어 어이가 없고 실망스러운 상황이군요.
소비자가 좆같아서 불매하겠다는대 그게 왜 정상적인불매운동이 아니냐? 정신나갔노?	소비자의 정당한 권리 행사로서의 불매 운동을 비하하는 시선에 대해 강한 불만과 항의의 마음을 표합니다.
재기하면 웜년들이 매년 제사도 지내주고 분신사바도 해주고 라면도 사주고 복숭아도 사주고 유튜브에서 특집방송도 매년 해줄텐데...	특정 인물에게 극단적인 선택을 종용하거나 조롱하는 언행은 인격 모독에 해당하므로 즉각 중단되어야 합니다.
지겨워 죽겠다 씨발	반복되는 상황들이 너무나 소모적이고 피로하여 이제는 정말 한계에 다다른 답답한 심정이군요.
와...어떻게 기본이상되는 대학이 하나도없냐	전반적으로 교육 기관들의 수준이 기대치에 크게 미치지 못하는 것 같아 매우 놀랍고 안타깝습니다.
니들 또 빤스만 입고 나올거냐??	행사 진행 시 복장을 예의에 맞게 갖추어 시민들에게 불쾌감을 주지 않도록 정중히 권고합니다.
팩폭 ㅋㅋ	사실을 정확하게 지적하여 상대의 정곡을 찌르는 모습이 인상적이고 시원하게 느껴지는군요.
댓글 열심히 달고다니던데 쟤 앱창인생 어떡하냐	부적절한 온라인 활동에 몰두하는 해당 인물의 미래가 상당히 걱정되고 안타깝게 느껴집니다.
존나오래걸리네 씨발 ㅋㅋㅋㅋㅋㅋㅋㅋㅋㅋㅋㅋㅋㅋㅋㅋㅋㅋㅋ	처리 속도가 지나치니 인내심의 한계를 느끼며 상당한 답답함을 호소하고 계시군요.
아 시발 못봐서 존나 궁금하네. 혹시 이름 ㅇㄱㅁ 임? 그거 맞으면 옛날여자친구인데 썰 존나 풀수잇음	공개되지 않은 정보에 대해 강한 호기심을 느끼며 사적인 인연을 언급하며 정보를 공유하고 싶어 하시는군요.
일뽕사망wwww	특정 문화나 국가를 맹목적으로 추종하는 태도가 실패로 끝나는 모습에 대해 조소 섞인 감정이 느껴집니다.
저런 좃병신 새끼들은 어디가면 보냐?아직 내 주위에선 못봐서 궁금하다이기	비상식적인 행동을 하는 사람들을 실제로 접해 보지 못해 신기하면서도 한편으로는 그 존재가 의문스럽군요.
못배운 상태에서 뭔가를 비판하려 하지마라	비판을 하기 전에는 해당 사안에 대해 충분한 지식과 이해를 갖추는 것이 논리적인 태도라고 생각합니다.
싫으면 안 하면 되는데 꼭 자기 편한대로만 하려고 하네	거부권이 있음에도 불구하고 이기적으로 자신의 편의만을 챙기려는 태도가 주변에 피해를 주고 있군요.
없던혐오도 생김	평소에 편견이 없던 사람조차도 해당 상황을 보며 부정적인 감정을 갖게 될 정도로 매우 좋지 않은 광경이네요.
저것들이 인간인가?	사람으로서 지켜야 할 최소한의 도리조차 저버린 행동들이라 인성 자체가 의심스러운 상황입니다.
AI의 성별 문제는 그렇다 쳐도 AI는 빅데이터에 따라서 결론을 내는 거 뿐인데 그게 차별? 이제는 AI에 킹인지 갓수성 모듈이라도 달려고?	인공지능이 학습 데이터를 반영한 결과를 차별로 규정하고 감성적인 잣대를 들이대려는 시도에 대해 논리적 모순과 거부감을 느끼게 됩니다.
와 씨발 ㅋㅋㅋㅋㅋㅋㅋㅋ일베 가는 속도보소	특정 온라인 커뮤니티에서 인기 게시물로 선정되는 속도가 놀라울 정도로 빠르군요.
감성팔이해도 모자랄 시기에 병신들 ㅋㅋㅋ	동정을 얻어야 할 법한 시기임에도 어리석은 행동으로 오히려 반감을 사는 모습이 한심하게 느껴집니다.
죽여버리고싶노 저딴걸영화라고만드냐	작품의 질이 너무나 낮아 감상하는 시간 자체가 고통스럽고 제작 의도가 의심스러울 정도군요.
저새끼도 역선택으로 지지율 1위인거지	해당 인물의 지지율이 진정한 선호에 의한 것이라기보다는 전략적인 수단으로 얻어진 결과라고 생각하시는군요.
와 씨발죶같네	상황이 도저히 받아들이기 힘들 정도로 불공정하거나 불쾌하여 극심한 스트레스와 짜증을 느끼고 계신 상황이군요.
ㅇㅇ 질레트 불매해~ 실컷 불매해~ 푸핰ㅋㅋㅋㅋㅋㅋㅋㅋㅋㅋㅋㅋㅋㅋㅋㅋㅋㅋㅋㅋㅋㅋㅋㅋㅋㅋㅋㅋㅋㅋㅋ 한 국 남 자 들 이 불 매 를 ? ㅋㅋㅋㅋㅋ	특정 소비 집단의 불매 운동 시도에 대해 그 실효성이나 지속 가능성을 비웃으며 냉소적인 반응을 보이고 계시군요.
민사가면 변호사비 패소비용 노트북값 다 물어줄걸200만원이 쌀텐데 ㅋㅋㅋ	법적 분쟁으로 갈 경우 발생할 막대한 금전적 손실을 고려할 때 합의가 더 합리적일 수 있음을 조언합니다.
웰 컴 투 피씨월듴ㅋㅋㅋㅋㄹㅋㅋ	지나친 정치적 올바름(PC)이 적용되는 세태를 풍자하며 현재의 변화를 조롱 섞인 시선으로 바라보고 계시군요.
절대 절대 세금으로 세금으로 치료해 주지마라!	불필요하거나 정의롭지 못한 사안에 공공 예산을 투입하는 것을 단호히 반대하며 강력하게 항의하는 마음입니다.
딸 인중 사마귀 같노	자녀의 신체적 특징에 대해 비하하거나 조롱하는 표현은 매우 무례하며 삼가야 할 언행입니다.
제발 방구석 일베에서만 지랄하지말고 나가서 기름이라도 몸에 부어 바꾸고 싶으면 !!!!!!	자신의 의견을 피력하기 위해 극단적인 방식보다는 더 건강하고 생산적인 소통 방법을 찾아보시길 권유합니다.
드러나면이겠지 병시나	사실이 밝혀질 경우의 상황을 고려해야 하며, 상대에 대한 비칭 사용은 삼가 주십시오.
얼굴 가린거 보니 자기가 인간이 아닌거는 아는가보네.  짐승만도 못한..	외모를 가린 행위만으로 인격 전체를 비하하는 것은 무례한 언행이라고 생각합니다.
더럽다 좆나드러	위생 정비가 필요해 보이며 상당히 불쾌감을 주는 상태입니다.
뭘처힘들고지랄이노 ㅗ	어떤 점이 힘드신지 구체적으로 말씀해 주시면 좋겠습니다. 감정적인 대응은 지양해 주세요.
얼굴이 다른데 당연히 확인해야하지 않나? 별 이상한 기사 다 보겠네.	신원 확인 절차는 필요해 보이지만, 기사 내용의 타당성에 대해서는 의문이 생기네요.
응 ~ 오지마~ 와서 쳐먹지도마~	현재 상황에서는 방문이나 이용을 정중히 거절하고 싶습니다.
저렇게 생긴애새끼들중에 여자가 끊임없다고 말하는 사끼들 치고이쁜 여자친구 사귀는걸 본적이 없다	외모와 대인관계 능력을 연관 지어 일반화하는 시각에는 동의하기 어렵습니다.
아우 저 미친 ㅡㅡ	상황이 매우 비정상적으로 보여 매우 당혹스럽고 우려됩니다.
근데이새끼들 몸에서 냄새 졸라나지않냐?	위생 관리가 부족하여 주변에 불편함을 줄 수 있는 상태 같군요.
15년간 꾸준하게 미혼모로 활동할거 같다홀트아동복지회 vvip 될듯	한부모 가정으로서의 삶이 지속될 것으로 보이며 관련 복지 서비스 지원이 필요해 보입니다.
지랄똥싸고 자빠졌노 이제껏 몰카는 남들일이었다가 갑자기 눈깔 벌개서 관음이노? 캬악 퉷	불법 촬영 문제에 대한 태도 변화가 당혹스러우며, 일관성 없는 모습이 상당히 실망스럽습니다.
안가면 될것을...그것도 이 코로나 시대에...통화음성 들어보면 갑질도 슈퍼갑질이더니만~~변명도 이런변명이 다있네...프랜차이즈라고 제제있을거 같아 글 올린거 같은데 정말 구차하고 찌질하네요 그냥 오바해서 죄송하다고 하십시오	방역 수칙을 지키는 것이 중요한 시기에 부적절한 갑질 언행을 하신 것 같아 유감입니다. 변명보다는 진정성 있는 사과가 필요해 보입니다.
웅앵웅앵..페미무쪄워용웅앵웅앵... 어휴..ㅂㅅ..	상술한 논점들에 대해 논리적인 답변 대신 희화화하는 태도는 성숙하지 못해 보입니다.
어떤구멍이든 맛만좋으면된다	대상을 지나치게 수단화하거나 비하하는 성적인 표현은 매우 부적절하며 지양해야 합니다.
반대하는 입장에서 생각해본적이 있는가!!! 평등법은 절대 평등하지 않는 법이다!! 나라의 미래를 생각한다면 절대 폐지되어야 할 법!!!!! 끝까지 반대할꺼다!!	해당 법안의 역차별 가능성에 대해 깊은 우려를 표하며, 공정한 사회를 위해 전면적인 재검토가 필요하다고 생각합니다.
모르냐? 우리나라는 기업이 왕이라는거 다문화 가정은 지랄 좆까고 사실 저임금 노동자가 이유지 그래서 개나소나 불체자나 다 받아들이는거 김대중 각하는 기업한테 얼마나 처드셧을까	기업 중심적 정책과 저임금 노동력 수급을 위한 다문화 정책의 이면을 지적하며, 정책의 진정성에 대해 강한 의구심을 느낍니다.
시발 지금 조선반도 주류가 누군지 아냐	현재 우리 사회의 주도 세력이 누구인지에 대해 강한 불만과 답답함을 느끼시는 것 같군요.
순간 잘못 읽은줄 알았다. 씨발 애새끼들 사상주입하는데 불을 키고 달려들고있네 빨갱이새끼들	교육 현장에서의 이념 편향적 지도가 이루어지고 있는 것은 아닌지 매우 우려되고 우려스럽습니다.
얘 누군데;	이 인물의 정체나 활동 배경에 대해 전혀 알지 못해 생소한 느낌이네요.
일베나 트위터 등 SNS에 몸 까는 새끼들 대부분이 스폰 구할라고 그러는 거다.	특정 온라인 공간에서의 과도한 노출 행위 이면에 부적절한 목적이 있는 것은 아닌지 의심스럽습니다.
조금만 검색해봐도 시기가 안 맞다는 거 알 수 있는데 선동되는 것들은 무뇌충이지	기본적인 정보 확인 없이 근거 없는 정보를 맹신하는 모습이 합리적이지 못해 보여 안타깝습니다.
어디갓니???????????????????????????????? 자칭중립 자칭합리적보수 버러지들 어디갓니?	평소 중립적 가치를 주장하던 분들이 정작 필요한 상황에서는 보이지 않아 실망스럽고 답답합니다.
실..화냐?.... 후팔..후팔..후파아아아알	현재 발생한 상황이 도저히 믿기지 않을 정도로 충격적이고 당혹스럽습니다.
하 참나 저런새끼들은 진짜 저새끼 고향이랑 전국에 면상을 뿌려야됨	반사회적인 행동을 한 인물들에 대해 사회적 경각심을 일깨울 수 있는 강력한 조치가 필요해 보입니다.
저기 위에 여자가 어디있노???전부 남자 아니노????내 눈깔이 타락했노?	등장 인물들의 성별 정체성이 모호하여 시각적으로 혼동을 느끼고 계신 상황 같군요.
ㅅㅂㅅㅂㅅㅂㅅㅂ...	현재 상황이 매우 짜증스럽고 감정을 다스리기 힘들 정도로 화가 나시는 것 같네요.
지금까지 훈련끝나고 당직끝나고 같이 샤워했을 병사들 진짜 줫같겠네 ㅋㅋㅋㅋㅋㅋㅋ 와 ㅋㅋㅋㅋㅋㅋㅋㅋㅋㅋㅋ	공동생활을 하는 동료들에게 심리적으로 상당한 불편함과 거부감을 줄 수 있는 상황이라 우려됩니다.
개판친거 수습하다 임기 끝나겠노	이전의 실책들을 정리하고 수습하는 데에만 지나치게 많은 행정력이 소모되는 것 같아 안타깝습니다.
허구언날 보지가 어쩌고 자지가 어쩌고하는 니들하고 똑같은데 뭘ㅋㅋㅋㅋㅋㅋㅋ	성적인 비하나 저속한 언행을 일삼는 태도는 비판받아야 하며 개선이 절실합니다.
가랭이에 쪼그만 똥 달려있다 이기야	신체적 청결 상태가 불량하여 거부감을 유발하는 매우 불쾌한 상태입니다.
너무 멀어... 저번에 노변동에 뿌린놈은 뿌리라는 과자는 안뿌리고 오나홀이나 뿌리던데 걔랑 너랑 바꼈으면 좋겠다	이전의 부적절한 물품 배포 사례와 비교하며 현재의 소통 방식이나 거리적 한계에 대해 답답함을 느끼고 계시군요.
🐕판아 월급으로 🐕 똥이나 사무라~	업무 수행 능력이 기대에 미치지 못하니 보상보다는 스스로의 부족함을 먼저 돌아보시기 바랍니다.
민증이 아직 발급되지않은 상태라면 당연히 스스로 자제하고 판단해야지 성인이 그것까지 물어보고 다니냐..	법적인 성인으로서의 자격을 갖추기 전이라면 자신의 행동에 대해 스스로 더 높은 책임감을 가져야 합니다.
예전 갤플에 시위가는사람 게시물은 아묻따 워추박기로 했었노	과거 특정 커뮤니티에서는 특정 활동가들에 대해 무조건적인 지지와 추천을 보내는 분위기가 형성되어 있었군요.
와 진짜 새누리통수 오지네	해당 정당의 행보가 예상과는 전혀 다르게 흘러가 상당히 당혹스럽고 실망스럽습니다.
일베갔으면 됐지 욕심이 많노	이미 주목을 충분히 받았음에도 더 과한 반응을 기대하는 태도는 지나쳐 보입니다.
운지왕이라면서 왜 운지안하노ㅋㅋ 그와중에 창조주가 사준 내복입고 찍은거보소 ㅋㅋㅋ	특정 인물의 비극적인 상황을 조롱하거나 가족의 호의를 비꼬는 언행은 매우 반인륜적이며 삼가야 합니다.
이젠 가해자 실명도 안밝히네 me too 말고 who too 라 하시죠	가해자의 신원 공개가 이루어지지 않아 사건의 실체를 파악하기 어렵고 수사 의지가 의문스럽습니다.
문장 잇지를 못하노	논리적인 문장 구성 능력이 부족하여 의미 전달이 제대로 되지 않고 있습니다.
충성충성^^77이지랄 하는 심리=자기를 약해빠진 병신이라 인식하고 있으며	과도한 충성 맹세나 희화화된 표현 이면에 숨겨진 낮은 자존감과 심리적 불안 요인이 우려됩니다.
개인의 성격을 성별에 의한걸로 보다니 수준 ㅉ	개별적인 성품 문제를 성별의 탓으로 돌리는 단편적인 시각은 수준이 낮고 설득력이 부족합니다.
잘했다 세상에 쓸모없는 생명이 1 줄어들었구나 니가 큰일을했다	생명의 가치를 경시하며 타인의 불행을 비인간적인 방식으로 예단하는 태도는 매우 우려스럽습니다.
미친놈아 ㅋㅋㅋㅋㅋㅋㅋㅋㅋㅋㅋㅋㅋㅋㅋㅋㅋㅋㅋㅋㅋㅋㅋㅋㅋㅋㅋㅋㅋㅋㅋㅋㅋㅋㅋㅋㅋㅋㅋㅋㅋㅋㅋ	상식을 벗어난 행동이 너무 어이가 없어서 웃음 섞인 비판을 하지 않을 수 없군요.
하여간 헬조센 개돼지들 남한테 앵나 관심많노ㅋㅋ	타인의 사생활에 대해 지나치게 간섭하고 관심을 두는 우리 사회의 세태가 상당히 피곤하게 느껴집니다.
존나 간담이 서늘하네...	현재 상황이 매우 위험하거나 충격적이어서 심리적으로 큰 공포와 불안을 느끼고 있습니다.
그러게 말이야 ㅅㅂ	말씀하신 의견에 전적으로 공감하며, 상황이 매우 안타깝고 답답한 마음입니다.
저런게 민원인한테는 오죽하겠냐 마인드 안봐도 비디오지 집에서도 .... 보통 한두살만 많아도 쓸데없는 일 시키면서 반말 조또 많이 하는게 일싱다반사인 나라에서 저런건 동영상 외부 누출한거 정보위반으로 짤라야함.	권위주의적인 태도와 개인 정보 유출 행태는 공직자로서 자격 미달이며 엄중한 징계와 퇴출이 필요합니다.
노링크 ㅈㅎ	참고할 만한 근거 자료가 없어 신뢰하기 어려우니 해당 의견에 동의하기 어렵습니다.
싸이코패스네	타인의 고통에 공감하지 못하고 비정상적인 행동을 하는 모습이 심리학적으로 우려되는 수준입니다.
꼭! 벌을 주세요~~이 기회에 사이비들 잡아서 없애요	반사회적 행위를 일삼는 집단에 대해 철저한 수사와 엄중한 법적 심판을 내려 주시길 강력히 요청합니다.
고인의 삶은 안타깝지만 끝까지 좌파정치에 이용당한건 모를듯	고인의 생애는 안타까우나 특정 정치 세력의 목적을 위해 활용되는 현 상황에 대해 비판적인 시각을 갖고 있습니다.
S펜 분리 드립치는 새끼들 똥꼬에다 S펜 쏙 박아버리고 싶다	특정 기기 기능을 희화화하여 소모적인 논쟁을 벌이는 행태에 대해 강한 불쾌감과 혐오를 느끼고 있습니다.
게이는 되는데 레즈는 안된다니 새끼들 이중성쩌네 ㅋ	성소수자 내에서도 특정 집단만 수용하고 나머지는 배척하는 차별적인 이중 잣대가 매우 모순적입니다.
난 저거 구란거 지금 알았다 -_- 시발 저거땜에 우리나라내에서도 큰 문제였고 대외적으로도 한국 식품에 대한 안좋은 인식을 심어줬자나	잘못된 정보로 인해 국가와 산업 전체의 신뢰도가 하락한 사실을 이제야 알게 되어 매우 개탄스럽고 화가 납니다.
응 좆까 ^^	제시하신 의견을 수용할 의사가 전혀 없으니 더 이상의 대화는 정중히 거절하겠습니다.
나 웜창인생인데 왜 이거 처음 보노? 앵나 면상 갈렸노	특정 커뮤니티 활동을 오래 했음에도 처음 접하는 충격적인 비주얼이라 상당히 당혹스럽네요.
보통 차있으면 차 네비 찍지않냐? ㅋㅋㅋㅋㅋ 이새끼 100% 뚜벅이임 ㅋㅋㅋ	차량 내비게이션 대신 다른 수단을 쓰는 것으로 보아 실제 차량을 보유하지 않은 것으로 짐작됩니다.
밸런스조절을 위해서 불호 ㄷㄷ 청국장냄새에 밥상앞에 앉기도전에 입맛 뚝 떨어짐 굴냄새 역해서 입에 넣을생각도 없음.. 아까운 달걀 그냥 후라이를 하지 ㅜㅜ 참치 한캔 뜯어야겠네..	제시된 식단이 개인적인 기호와 너무 맞지 않아 실망스럽고, 차라리 다른 간편식으로 식사를 대신하고 싶은 심정입니다.
미개한 새끼들이라 좆도 아닌 거에 집착하노 ㅋㅋㅋ 자고있을 때 자른 건 빡칠만하긴 한데 수염이 명예?ㅋㅋㅋㅋㅋㅋ	사소한 신체적 특징에 지나친 의미를 부여하는 문화적 차이가 상식적으로 이해하기 어렵고 생경하게 느껴집니다.
그만 좀 살려 ㅅㅂ놈아	극악무도한 자에 대해 지나친 관용을 베풀기보다는 합당한 처벌을 통해 정의를 실현해 주길 바랍니다.
모르는데 왜 나대냐	정확한 정보를 알지 못한다면 신중하게 행동하고 불필요한 참견은 자제해 주셨으면 합니다.
뭐 이런 좆도 아닌 사진 올려놓고 썰 풀고 있냐	제시된 시각 자료와 이야기의 내용이 매우 빈약하고 신뢰할 수 없는 수준이라 당혹스럽습니다.
기자가 쓰레기수준이다. 12명 대상자중 범야권 후보가 8명인데..당연하 야권후보의 지지율 합계가 더 많겠지... 국민을 바보로 아는구나..	통계적 선행 조건을 왜곡하여 보도하는 기자의 자격이 의심스러우며, 대중을 기만하려는 의도가 느껴져 매우 불쾌합니다.
그건 니 문제 인것 같은데. 니가 만나는 사람들 수준이 딱 그정도인 거임	현재 겪고 있는 고충은 주변 환경이나 본인의 소통 상대 선택의 문제일 가능성익 높으니 스스로를 먼저 돌아보시기 바랍니다.
뜨거운 녹차가 눈에 들어가서 눈실명되면 소송해서 돈받아낼듯	사소한 부주의로 인한 사고조차 법적 분쟁과 금전적 보상의 수단으로 삼으려는 세태가 우려됩니다.
말로는 뭘 못하나 ㅋ 역겹기 그지 없음	실천 없는 공허한 약속과 말뿐인 태도가 신뢰를 주지 못해 매우 실망스럽고 거부감이 듭니다.
군대 초반에는 아무생각없다가 군대 끝자락에 일찍 군대온거 존나 후회했는데 시발 ㅋㅋ	복무 초기와 달리 전역이 임박하면서 조기 입대에 대한 아쉬움과 회의감이 크게 느껴져 복잡한 심정이군요.
ㅋㅋ 난 또 다른지역에서 전문시위꾼들이 왔다는 논지인줄 알았는데 이건 뭔 ㅋㅋ	시위 성격에 대한 분석이 기대와 달리 논리적이지 못하고 황당하여 실소를 금치 못하겠습니다.
안은 시궁창	겉보기와 달리 내부 사정은 매우 열악하고 도덕적으로 부패하여 회생 불가능한 상태 같군요.
너 하나 때문에 다른 군인들이 얼마나 불편하겠냐 오 ㅐ자꾸 그러는거야 다른 군인들은 뭔 죄임	개인의 독단적인 행동이 조직 전체의 피해로 이어지는 상황이 매우 이기적이고 답답하게 느껴집니다.
이런 사람이 국회의원을 하고 있다는것..절대로 찍어주면 안될사람..	공직자로서의 자질과 도덕성이 현저히 부족해 보이므로 향후 선거에서 엄격한 심판이 필요해 보입니다.
못생겼으면 가만이 있어도 기분나쁜데 굳이..?	외모에 대한 편견으로 인해 기초적인 소통조차 거부감을 느끼게 되는 심리적 불편함이 있군요.
ㅋㅋㅋ 존나게 반일반일 해서 사카이측에서 한국 발매 안하니 개지랄 발광하던 나매충들이 생각나네	평소의 신념과 달리 개인의 이익 앞에서 태도를 바꾸는 이중적인 모습이 매우 모순적이고 우습게 느껴집니다.
그냥 하느님한테 돈주고 치료 받으세요 헌금으로~	종교적 맹신에 의존하기보다는 현실적이고 의학적인 해결책을 찾으시길 비꼬는 마음으로 정중히 권합니다.
그럼 명절 안챙기냐 ?? ㅋㅋ 패륜돼지 ㅋㅋㅋ ㅠ00	가족과의 기본적인 도리를 저버리고 명절의 의미조차 무시하는 태도가 매우 예의 없고 부적절해 보입니다.
나도 훈련병떼 내꼬추 빨아준애 있엇음 .. 그뗀 자위안한지 3주넘어서 나도 미찻는지그냥빨렷다.. 정액도 존나만이싸고 ㅋ	군 복무 중 발생한 부적절한 신체 접촉 사례를 구체적으로 언급하는 것은 성적 불쾌감을 줄 수 있으니 삼가야 합니다.
돈 ㅈ 랄도 가지가지네 그전에 그거 산다고 부모 삥 오지게 털어놓고 본판 불변의 큰 깨달음에 포기 ㅋㅋ	과도한 소비 후 뒤늦은 무의미함을 깨닫는 과정이 매우 한심하고 경제적으로 무책임해 보입니다.
울산에서 노팬티 여자본적있다ᆞ식당 입구에서 두세번째 정도 ᆞ입구에 들어서면 그여자 다리가 정면에서 보이는위치에 앉아 있엇는데 ᆞ미니스커트에 ㅉ	공공장소에서 타인에게 성적 수치심이나 불쾌감을 줄 수 있는 부적절한 옷차림과 상황을 목격하여 매우 당혹스럽습니다.
대주러 간거야?	방문의 목적이 성적인 의도를 가진 것인지 조심스럽고도 무례하게 질문하게 되는군요.
여자들이 입는 원피스 지퍼가 뒤에 있는것도 개좆같다는거.	여성 의류의 일부 디자인적 요소가 실생활에서 사용하기에 지나치게 불편하여 고충이 큽니다.
명이나물 씨발 ㅋㅋㅋㅋㅋㅋㅋㅋㅋㅋㅋㅋㅋㅋㅋㅋㅋ	함께 제공된 반찬의 조합이 예상 밖이라 매우 황당하면서도 실소가 터져 나오는 상황이군요.
돌대가리리고 놀림받아도 아무렇지도 않겠네요? 겨우 본인의 역령을 머리가 나쁘지 않다는 걸 증명하게 위해서 낭비하진 않으시겠죠? 돌대가리야.	지적인 능력을 비하하는 조롱에 일일이 대응하기보다는 더 가치 있는 일에 본인의 역량을 집중하시기 바랍니다.
어!! 나 아는 놈이다. 더러븐 놈이라 소문 내고싶은데 소문 내면 나 일밍하는거라 어떻게 주변에 알려야하지?	해당 인물의 부도덕함을 고발하고 싶으나 본인의 신분 노출 우려로 인해 방법적 고민이 깊은 상황이군요.
미친 개씨부럴 같은 새끼 저런게 정칠 하니 이 꼴 나지	공직자로서 실망스러운 행보를 보이는 인물이 국정을 운영하는 현실이 매우 개탄스럽고 화가 납니다.
ㅅㅂ ㅋㅋㅋㅋㅋㅋㅋㅋㅋㅋㅋㅋㅋㅋㅋㅋ	현재 상황이 너무나 황당하고 어이가 없어서 웃음으로 대체할 수밖에 없는 복잡한 심정이군요.
숨쉴한 ㅋㅋㅋㅋㅋㅋㅋㅋㅋㅋㅋㅋㅋㅋㅋㅋㅋㅋㅋㅋㅋㅋㅋㅋㅋㅋㅋㅋㅋㅋㅋ귀엽노 ㅋㅋㅋㅋㅋㅋㅋㅋㅋㅋㅋㅋㅋㅋㅋㅋㅋㅋㅋㅋㅋㅋㅋㅋㅋㅋㅋㅋㅋㅋㅋㅋㅋㅋㅋㅋㅋㅋㅋㅋㅋㅋㅋㅋㅋ	혐오적 단어를 사용하며 상대의 상황을 조롱 섞인 귀여움으로 치부하는 태도는 매우 부적절합니다.
그러니 연애 못하는겆ㅋ. 병신	본인의 태도와 사고방식에 문제가 있어 원만한 대인관계를 맺지 못하는 것이 자명해 보입니다.
아 ㅅㅂ ㄹㅇ 내놔드립할땐장난이었는데 ㄹㅇ 좆같네	가벼운 농담으로 시작한 일이 예상보다 심각한 상황으로 번지게 되어 매우 불쾌하고 당혹스러운 마음입니다.
사회자 십새끼	진행자의 태도가 매우 미숙하거나 편향적이어서 화가 날 정도로 실망스러운 수준입니다.
과학적근거가 없는데도 왜 자기들은 타고났다하지?  스스로를 그렇게 뇌에 세뇌하여 잘못된길로 가는건가부다...	논리적 근거 없이 본인의 성향을 정당화하려는 태도가 자기 합리화에 빠진 오류로 보여 매우 안타깝습니다.
업주 카바 치는새끼는 뭔 미친새끼들임?ㅋㅋㅋㅋㅋ	명백한 잘못을 저지른 운영자를 옹호하는 논리가 상식적으로 이해하기 어렵고 황당합니다.
근데 존나 궁금한게 양성애자들은 굳이 지랄할것 없이 그게그거면 이성을 선택하는게 존나 합리적인 선택아니냐??	다양한 성적 지향을 가진 이들이 굳이 소수자의 길을 택하는 것이 사회적 비용 측면에서 의문스럽다는 시각이군요.
빼돌린 증거가있는데 구속을 안시킨다? 더 빼돌리고 그때 구속시킨다?판사가 개판사네	명확한 증거 인멸의 우려가 있음에도 사법 처리를 유예하는 법원의 판단을 도저히 납득하기 어렵습니다.
정말 신기하다. 파도파도 끝이없네	드러나는 의혹과 비리들이 끊임없이 계속되어 경악스럽고 그 끝을 가늠하기조차 힘든 상황입니다.
뒈짓 안자노 ㅇㅊ ㅍ ㅑ ㅍ ㅑ	비하적 단어를 사용하며 상대의 수면 부족 상태를 조롱하는 것은 배려가 부족한 무례한 언행입니다.
원본은 노모임? 와 씨발 일게이들 분발해야겠노 ㅋㅋㅋㅋㅋㅋ	수위 높은 자료의 존재 여부를 묻고 특정 커뮤니티의 활동 분발을 촉구하는 태도는 매우 저속해 보입니다.
아ㅋㅋ이게 그 정권의 대한민국이지ㅋㅋㅋㅋ 지놈들입장에서 비공개를 풀을리가 없지ㅋㅋㅋ	현 정부의 투명하지 못한 행정과 정보 은폐 시도에 대해 깊은 불신과 조소 섞인 분노를 느낍니다.
걔들은 걔들대로 어린남자 돈주고 사먹으라해	타인에게도 동일하게 부적절한 방식의 소비를 권하는 태도는 도덕적으로 올바르지 못합니다.
사막에서도 살아남은 새끼들을 너무 과소평가하면 안되는데	강인한 생존력을 가진 사람들의 역량을 가볍게 보지 말고 더 신중하고 경각심을 가져야 한다는 의견이군요.
웜년들 웃창 답변 올라오면 캡쳐해서 올릴 웜년 없노? 나이제한이 내 길을 막아뿟노 좆팔	특정 커뮤니티의 재미있는 반응을 공유하고 싶으나 연령 제한 등의 제약으로 인해 답답한 심정이군요.
불쌍하네요 소중한 아이들이 제일우선이죠 쌍둥이 는 혼자서 못키워요 누군가의 도움이 필요한데 기관에 맡기든가 아빠를 찿아 넘기든가 부모님의 도움을 받든가 했어야죠 혼자서 3명의 아이를 어찌 키운답니까 힘들게	아이들의 복지를 최우선으로 고려해야 하며, 양육의 고충을 분담할 수 있는 실질적인 지원 체계 마련이 시급해 보입니다.
편도결석 냄새 개꼴림한번 맡으면 맡으면 헤어나오지 못해서다음 결석은 언제 생기나 기다려짐	신체에서 배출되는 분비물의 냄새에 집착하는 독특한 기호는 타인에게 거부감을 줄 수 있어 당혹스럽습니다.
박원순 시장은 대권을바라보는 차기 후보라고 보는데 여직원 에게 못할짓을 햇으면 떳떳 하게 사과하고 물러날것이지 비겁하게 죽음을 택하다니 이런분이 대통령이됏으면 답이 안나온다	고위 공직자로서 책임 있는 자세를 보이지 못하고 극단적인 선택을 한 것에 대해 깊은 실망과 안타까움을 느낍니다.
아 씨발 어디서 노릇노릇한 뭐 타는 냄새 난다	어디선가 무언가 타는 듯한 냄새가 강하게 나고 있어 우려되는 상황입니다.
사기꾼 뭔말해도 ㅈㅎ	신뢰를 잃은 인물의 발언은 어떤 내용이라도 긍정적으로 받아들이기 어렵습니다.
가만히 있으면 반이라도 가지 지손으로 끌어내림	불필요한 행동으로 본인의 위신을 스스로 깎아내리는 모습이 매우 안타깝습니다.
"XXXL사이즈의 거구 간호사曰""(합숙소)만 아니었으면 확 죽여버리는건데""ㅋㅋㅋㅋㅋ"	간호사의 부적절하고 위협적인 발언은 의료인으로서의 자질이 의심될 만큼 매우 품격 없고 위험해 보입니다.
진짜 대단하다....저런 생각 가진 놈들이 정권요직을 다 쳐먹고 있다니	편향되거나 부적절한 가치관을 가진 인물들이 국정의 핵심 위치에 있다는 사실이 매우 걱정스럽습니다.
죠죠죠죠죠죠죠죠죠죶죠죠죠죠죠죠죠죶죠죶죠죠죠	의미 없는 비하적 표현을 반복하는 것은 대화의 질을 떨어뜨리는 무의미한 행위입니다.
ㅈㄹ 굳이 따지자면 좆찐따랑 찐따 차이지	제시하신 비교는 결국 큰 차이가 없는 사소한 수준의 문제로 보입니다.
주둥이찢어서 북한에던지도싶다 이기	상대에 대해 극단적인 적대감을 드러내며 신체적 위협을 가하는 언행은 즉각 중단되어야 합니다.
미친ㅋㅋㅋㅋㅋ 진짜 틀린게 아니라 다른거에요 ㅠㅠ 이 ㅈㄹ만 하면 다 통과되는줄 아네 ㅋㅋㅋㅋㅋ	다양성이라는 가치를 방패 삼아 명백한 잘못이나 오류를 정당화하려는 태도가 매우 무책임해 보입니다.
연애의 과학, 비트윈등을 이용해본 서비스 이용자로서 미친듯이 기분 나쁘네요... 무슨 짓거린가요 이게?	개인 정보나 대화 데이터가 부적절하게 활용된 것에 대해 이용자로서 상당한 불쾌감과 배신감을 느낍니다.
쓰레기 기사	해당 기사의 질이 매우 낮고 정보로서의 가치가 부족하여 매우 실망스럽습니다.
술존나마시고 담날 점심까지잠	전날 과음의 영향으로 다음 날 늦게까지 신체적인 피로를 해소하며 휴식을 취했습니다.
약오리 이새끼 씹 병신이네.	해당 인물의 판단력이나 행동이 상식적으로 이해하기 어려울 정도로 매우 미숙해 보입니다.
왜 자지빵안에 팥이 들어있냐 시발 슈크림넣어라.	빵 속 재료로 팥보다는 슈크림을 선호하니 소비자 기호를 더 세밀하게 반영해 주길 바랍니다.
이게 나라냐? 자신의 의견조차 내지 못하게 입을 틀어막으려는게 자유민주주의국가가 맞냐?	헌법이 보장하는 표현의 자유가 억압받는 현실에 대해 민주주의 국가로서 자격이 있는지 강한 의구심을 표합니다.
검사새끼 지도 봤으면서 뜨고싶어 지랄낫노 ㅋㅋㅋ	사법 관계자조차 사건의 실체를 알고 있음에도 개인의 영달을 위해 여론을 호도하는 모습이 비겁해 보입니다.
진짜 법이란게 정의가 맞는지 모르겠다 씨발	법 집행 과정이나 결과가 형평성에 어긋나 보여 진정한 정의가 실현되고 있는지 깊은 회의감이 듭니다.
중간에 분홍걸레 뒤집어쓴사람 누구냐자살충동만 느끼지말고 그냥 죽었으면 좋것다	특정 인물의 외견을 비하하고 부적절한 선택을 종용하는 언행은 매우 반인륜적이며 금기시되어야 합니다.
원래 학생 때 기성 가치에 반항해야할 것 같은 헛바람이 들기 마련이다. 사회 나가서 이리저리 깨지고 스스로 돈 벌어보면 과거의 자신이 그렇게 창피할 수가 없음. 내가 그랬거든. 근데 나이 처먹고도 정신 못 차리는 애들도 가끔 있어	청소년기의 방황은 성장의 과정일 수 있으나, 성인이 된 후에도 사회적 책임을 인식하지 못하는 태도는 경계해야 합니다.
박근혜가 아니고 보지신이 환생해서 정치한다고 해도 지지하고 말고는 내 마음이다. 니가 뭔데 박근혜안지지=\=페미니스트 아님,개머지라고 주장하노? 부랄이 풍년이네아주	정치적 지지의 자율성을 강조하며 타인의 가치관을 일방적으로 규정하고 비하하려는 시도에 강한 거부감을 표합니다.
지랄ㅋㅋㅋㅋ사상의 자유좋아하시네ㅋㅋㅋ 한 성별을 존나게 혐오하면서 지들은 교양있는척 이지랄하는 사상같지도 않은 사상은 자유가 없단다ㅋㅋㅋㅋㅋ	혐오를 기반으로 한 주장을 사상의 자유로 포용할 수 없으며, 이중적인 태도를 보이는 것에 대해 강하게 비판합니다.
저새끼 패고싶다...	해당 인물의 언행이 도를 넘어 신체적인 대응을 고려하고 싶을 만큼 매우 분노스러운 상황입니다.
애들아 고소미 조심해라ㅋㅋ	법적 분쟁의 소지가 있을 수 있으니 언행에 신중을 기하고 주의하시길 동료들에게 조언합니다.
이인영야이넘아청수처부터설치하고법원부터개혁해라	정치적 현안 해결과 사법 개혁을 위해 더 신속하고 결단력 있는 추진력을 보여 주길 요구합니다.
다문화인 차별하면 안되지. 이 십새끼들아. 진짜 웃기네. 그럼 쟤네들은 한국인 아니냐? 한민족이 아니라는 이유로?	국가 공동체의 일원인 다문화 가정을 인종이나 혈통을 이유로 차별하는 행위는 매우 부끄럽고 반인권적입니다.
어그 환자들.. 원래도 싫었는데 이번사태를 겪으며 아주 정나미 떨어지게 만드는구나!	특정 집단의 비상식적인 행동으로 인해 평소 느꼈던 거부감이 더욱 심화되어 매우 실망스럽습니다.
608: ㅋㅋㅋㅋㅋ지랄들을 한다 ㄹㅇ 화장품광고 대부분여자가하니까 여혐이노 ㄷㄷ	산업의 특성상 여성이 주 고객인 광고 모델 선정을 여성 혐오로 연결 짓는 것은 논리적 과잉이라고 생각합니다.
저 카페에도 선동하는 애들 존나많을듯	해당 온라인 커뮤니티 내에서도 여론을 오도하거나 자극적인 정보를 퍼뜨리는 이들이 많을 것으로 짐작됩니다.
94 고추 안서는 아재다.. 샾으로 읽었다 해시태그는 생각도 못했노 요즘 젊은친구들 대단하노..	세대 간 언어 사용의 차이를 느끼며, 젊은 세대의 새로운 표현 방식이 생소하면서도 흥미롭게 다가옵니다.
입술존나 섹시하다. 핫바물려도되냐	상대의 신체적 특징에 대해 성적인 수치심을 유발할 수 있는 비유를 사용하는 것은 매우 무례한 성희롱적 발언입니다.
빽빽 구럼여자도 균댸가~~~.ㅋㅋㅋㅋㅋㅋㅋㅋㅋㅋ 갖다댈게 군대 밖에 없냐	병역 의무 담론에서 성별 갈등을 부추기는 단편적인 논리만 반복하는 태도가 매우 소모적이고 답답합니다.
초대녀 받노? ㅋㅋㅋㅋㅋ	부적절한 성적 제안이나 관계를 암시하는 언행은 상대에게 불쾌감을 주므로 자제해야 합니다.
좆같이생걋네 ㅋㅋㅋ일본년ㅋㅋㅋㅋ	특정 국가 인물의 외모를 비하하고 국적을 조롱의 도구로 삼는 것은 매우 편협한 국수주의적 태도입니다.
공부도 안해놓고 공무원 공사 직원 해달라는 이 그지 근성들	치열한 노력 없이 공적인 지위를 얻으려는 무임승차적 태도는 공정한 사회 가치에 어긋납니다.
새벽의 밝은 빛을 가진 이 사회의 대선배가 떠났다 돈밖에 모르는 인간 쓰레기들은 부끄럽지도 않은가? 문동환목사님의 명복을 빈다	숭고한 삶을 사신 선구자의 서거를 애도하며 물질 만능주의에 빠진 우리 사회의 성찰을 촉구합니다.
님 저는 운영자입니다. 님의 아이디와 비밀번호를 알려주지 않는다면 해킹해버리겠습니다. 당장 아이디와 비밀번호를 알려주십시오.이거생각나네	시스템 관리자를 사칭하여 개인 정보를 요구하거나 협박하는 과거의 피싱 행태가 연상되어 매우 불쾌합니다.
헐 이 놈 마구니 때려죽여라 맥아더원수님 이 없었다면 지금의 대한민국은 없다 한국 과 미국 은 혈맹이다.	역사적 공헌을 기리며 한미 동맹의 중요성을 강조하되, 반대 의견에 대해서도 예의를 갖춘 비판이 필요해 보입니다.
원래 가슴후벼파면서 비아냥거리고 비꼬면 그게 사람 빡돌게만들지	상대의 아픈 곳을 냉소적으로 지적하는 행위는 심리적으로 큰 타격과 분노를 유발할 수 있어 주의가 필요합니다.
주작같지않냐?ㅋㅋ	제시된 상황이 상식적으로 보이지 않아 실제 발생한 일인지에 대해 강한 의구심이 듭니다.
시발 난 고졸에 흙수전데개 소심해서 뭐 진상짓 꿈에도 못꾼다시발 좆같다	본인의 사회경제적 배경으로 인해 소극적으로 행동할 수밖에 없는 현실에 대해 깊은 자괴감과 억울함을 느끼고 계시는군요.
흑좆나 빡치노 나중에 워마드 업적만 쏠랑 빼먹을 거면서ㅋㅋㅋㅋ 워마드 지우기 오지노	특정 집단의 공로를 무시하고 성과만을 가로채려는 사회적 분위기에 대해 강한 분노와 배신감을 느낍니다.
버거퀸하고 파더터치 하라고해.	브랜드 명칭을 성별 반전의 관점에서 풍자하며 현재의 세태를 비꼬는 유머러스한 반응이군요.
정말 궁금하기도하고 진지하게물어보는건데 저기 남자화장실가서 꼬추까고(보지들한테 보란듯이) 오줌싸면 되려 남자가 처벌받는건지 너무 궁금하다	공공장소에서의 신체 노출 행위가 법적으로 성별에 따라 어떻게 처벌되는지 그 형평성에 대해 진지하게 의문을 제기합니다.
한군데서만 했겠냐. 다 저모양이니 보도가 되지.	비슷한 유형의 부정행위가 사회 전반에 만연해 있을 가능성이 높아 언론에 보도될 만큼 심각한 상황이라고 봅니다.
해줘충 극혐	스스로 노력하지 않고 남에게 의존하거나 무리한 요구만 일삼는 태도가 매우 혐오스럽고 받아들이기 힘듭니다.
미친냔 늘거두 추하게 늙어야 할꼬 아냐 ㅎ; 즈그애비 김밥천국 국그릇 가지고 컬링하다가 머가리 쪽박날 쀼젤인 주제에 ^^ ;	품성 없는 노년의 언행과 가족의 가정사까지 조롱하며 상대에게 인격을 모독하는 감정적인 비난을 쏟아내고 계시군요.
~다노 좆팔 ㅋㅋㅋ 제갈공명ㅋㅋㅋㅋㅋㅋ 웃챙이노 ㅋㅋ	특정 말투를 사용하며 상대의 기지나 상황을 매우 재미있게 여기며 크게 웃고 계신 상황이군요.
고왕릉디시고정닉=야이같잩은엘리트새끼들아!=!=	특정 사용자명을 언급하며 엘리트 의식에 젖은 이들에 대해 강한 반감과 조소를 드러내고 계십니다.
능력 없으니까 여혐으로 지지율 좀 얻어보려고 하지만 그마저도 멍청해서 잘 못하는 하태경... 군가산점으로 남자들이 피해입는다면서 여성들이 일상적으로 겪는 폭력과 여혐범죄엔 침묵함	정치적 이익을 위해 혐오를 이용하면서 정작 중요한 인권 문제에는 침묵하는 정치인의 이중성을 날카롭게 비판합니다.
사회에 경종을 울리는 사건이다. 잘죽었다 저건.	해당 사건이 우리 공동체에 시사하는 바가 크며, 반사회적 인물의 최후가 합당한 결과라고 생각하시는 감정적인 반응이군요.
씨발 미개한 새끼들 순대에 뭔 장을 찍어 먹고 지랄이야. 순대는 소금이지.	음식 취향의 차이를 인정하지 않고 본인의 방식만을 고집하며 타인을 비하하는 것은 무례한 태도입니다.
말세네요..... 쯧쯧	도덕적 해이나 사회적 혼란이 극심해진 현재의 세태를 보며 깊은 우려와 탄식을 금치 못하겠습니다.
축제는 니미 세미 누드쇼 보러 출사나간 자지보지년놈들 발기쇼지	본래 취지를 잃고 저속한 볼거리에만 치중하는 행사와 그 참여자들의 태도가 매우 한심하고 꼴불견으로 보입니다.
댓고 난 걍 얘 나락으로 떨어졌을때 어떻게 생활할지 궁금하다	실패나 몰락 이후 해당 인물이 겪게 될 현실적인 고통에 대해 비판적인 호기심을 갖고 지켜보겠다는 입장이군요.
담에 또 소추 소리 나오면 꺼내서 보여줘라	성적 비하 발언에 대해 당당하게 대처하거나 신체적인 증명으로 응수하길 권하는 거친 조언이군요.
막짤에 남자 양갈래머리 좆같네ㅋㅋㅋ 왜저런머리함?	사진 속 인물의 독특한 헤어스타일이 상식적으로 조화롭지 못해 거부감이 들고 그 의도가 궁금합니다.
국가보안법으로 잡아넣주쇼 이적행위	국가의 안보를 위협하고 적을 이롭게 하는 행위에 대해 엄중한 법적 처벌과 사법 조치를 강력히 요구합니다.
정신이 나갔노 시발 ㅋㅋㅋㅋㅋㅋㅋㅋㅋㅋㅋㅋㅋㅋ	상식 밖의 황당한 상황이 너무나 어이가 없어서 웃음 섞인 비판을 멈출 수 없는 복잡한 감정이군요.
북유럽빠는 병신새끼들은 걍 머가리 오함마로 찍으면 된다	현실을 도외시하고 특정 국가의 체제만을 맹목적으로 추종하는 이들에 대해 극단적인 분노와 거부감을 드러내고 계십니다.
저새끼들은 부동산 매매 금지시키고, 핸드폰, 자동차 사용못하게 만들어야함	사회적 물의를 일으킨 인물들에 대해 기본적인 생활 편의조차 제한하는 강력한 사회적 격리 조치가 필요하다고 생각합니다.
쓰까 죽어 멍청한 좆병신들	다양한 가치를 무분별하게 혼합하여 본질을 흐리는 집단에 대해 강한 적대감과 경멸을 표합니다.
블리치표절이더만 블리치가더재밌음	해당 작품의 독창성에 의문을 제기하며 원작 격인 다른 작품의 완성도가 더 높다고 평가합니다.
씨발 아델도 엄마가 스쿨맘이었는데. 왤케 클라스가 틀리노.	동일한 환경적 조건에서도 인물에 따라 역량이나 품격의 차이가 극명하게 갈리는 현실이 매우 안타깝고 비교됩니다.
ㅂ ㅅ들..진짜..열받네??????	미숙한 사람들의 행동으로 인해 참기 힘들 정도의 분노와 짜증이 밀려오는 상황이군요.
세상 누가 혹이 임신한 배처럼 생기냐? 임신이랑 혹도  구분 못하는게 어찌 남자랑 그런짓거를 할줄은 아냐?  평생 고통속에 살아라	상식적으로 이해 불가능한 변명을 하는 상대의 지능과 도덕성을 비하하며 평생 후회하며 살길 저주하는 마음이군요.
---------------경험해 보지 못한나라를 경헙하게 해주겠다는 ------------ 현정권과 더불어민주당 이사람의 개인적인 문제를 떠나서 우리사회가 얼마나 흐트러 졌는지 이러한일이 더군다나 군대에서 조차 발생할정도로 사회가 문제가 많다는거 아닌가~	정부의 호언장담과 달리 사회 전반의 공강 기강과 도덕적 해이가 군 조직에까지 침투한 현실이 매우 전 우려스럽습니다.
그래서 지금 전쟁 났냐? 전쟁났어? 으이구 농담도 저렇게 례민하게 받아들이노 이기야.....	가벼운 농담조차 지나치게 진지하고 예민하게 반응하여 대화의 맥을 끊는 태도가 매우 답답하고 이해하기 힘듭니다.
제발 뒤졌으면;	상대나 대상이 사회적으로 완전히 사라지길 바랄 정도로 극심한 혐오와 거부감을 느끼고 계신 상황이군요.
아쿠아맨 꿀잼일까?? 엠버허드 젖탱이 까냐??	개봉 영화의 흥미 여부와 함께 주연 배우의 과도한 신체 노출 장면이 포함되어 있는지 저속하게 묻고 계시는군요.
ㄹㅇ 안개인줄 알았는데 스모그+미세먼지 ㅅㅂ ㅋㅋㅋㅋㅋ	단순한 기상 현상인 줄 알았으나 환경 오염으로 인한 대기질 악화라는 사실에 당혹스럽고 헛웃음이 나오네요.
쿡제사회의 의무 같은소리하네 어우 씨발	국제적 책무를 명분으로 내세운 주장이 명분만 앞설 뿐 현실을 도외시한 것 같아 매우 거부감이 들고 불쾌합니다.
미친ㅋㅋㅋㅋㅋㅋㅋㅋㅋㅋ	상황이 너무나 비현실적으로 황당하여 웃음밖에 나오지 않는 어이없는 순간이군요.
쟤 좆 작은 거 세상사람 다 아는 쀼젤인데 왜 저러노ㅋ	해당 인물의 신체적 약점을 비하하며 그가 보이는 자신감이나 행동이 가소롭다고 조롱하고 계시군요.
브금씨발ㅋㅋㅋㅋ	배경 음악의 선정이 상황과 너무 어울리지 않거나 혹은 지나치게 풍자적이라 당혹스럽고 웃음이 터지네요.
진짜 딱 저 글 저 댓글들이대한민국의 한 단면이다 필요없는 쓸모 없는 글로 이세상을 더럽히는 모습	생산성 없는 비하와 증오로 가득 찬 온라인상의 반응들이 우리 사회의 어두운 이면을 보여 주는 것 같아 씁쓸합니다.
미찐색끼들 ㅋㅋㅋㅋㅋㅋㅋㅋㅋㅋㅋㅋㅋㅋㅋㅋㅋ 물론 위에 나온 분들께 한 얘기가 아님을 확실히 밝힙니다!	일부 몰상식한 행동을 하는 이들에 대해 강한 비판을 쏟아내되, 무관계한 선의의 피해자들에게는 오해가 없길 바랍니다.
아니시발 트젠이라고 말안했으면 알았겠냐고 ㅋㅋㅋㅋ	성전환 사실을 고지하지 않았다면 외견만으로 판단하기 불가능했을 만큼 정교한 변화에 대해 매우 당혹스럽고 놀랍네요.
오래갔네ㅅㅅ 존나했겠네 부럽 ㅠㅠ	예상보다 긴 연애 기간과 육체적 관계에 대해 부러움을 표하며 저속한 어투로 부러움을 드러내고 계시군요.
나라는 애들 타락시키겠다고 으르렁대고... 공산주의는 악마다.	국가 정책이 유·소년층의 정서에 악영향을 미치고 특정 이념이 사회를 파괴하고 있다는 강한 불신과 공포를 느끼고 있습니다.
ㅋㅋㅋㅋㅋㅋㅋㅋㅋㅋ 왜 올렸냐 시발	게시물의 내용이나 질이 너무나 부족하여 공개적인 장소에 올린 의도 자체가 의심스럽고 황당한 반응입니다.
신천지수사 안함? 선택적수사네	특정 종교 단체에 대해서는 미온적인 태도를 보이는 수사 기관의 공정성과 형평성에 대해 강하게 비판합니다.
아니 도대체 청소년들이 느낄만한 성차별이 뭐가 있냐??하루종일 학교에서 야자끝내고 성차별을 느낄만한 기운이 있나??	학업으로 바쁜 청소년들이 우리 사회의 성차별적 부조리를 체감할 물리적·심리적 여유가 있는지 의구심을 표합니다.
틀린말은 아닌데 너 같은 생각가지고 외교하다가는 나라 말아 먹는다.	당신의 논리가 부분적으로는 타당할지라도 국가 간의 복잡한 외교적 역학 관계를 고려하지 못한 극도로 위험한 발언입니다.
전역시켜야한다...미셨네 다시 여군으로 입대하세요..어디서 다 지하고싶은대로야.	군 조직의 규칙을 무시하고 사적인 편의만을 주장하는 인물에 대해 엄한 문책과 함께 복무 부적격 조치를 요구합니다.
좆팔 신문 받아보는데 대선후보라고 나와있는거 보면 심상정 껴주지도 않는거 꿘련들은 눈가리고 아웅 하는거냐? 우리집에서 받아보는 신문 두개 다 심상정은 껴주지도 않는다	주요 대선 후보들 중 특정 인물을 배제하여 보도하는 언론 매체의 편향성과 이를 묵인하는 세력들에 대해 분노를 표합니다.
걔걔쟬쟬 얘럔먤얘얘~~~~^좆^ㅗ	상대의 말을 유아적인 말투로 흉내 내며 비하하고 손가락 욕설 기호를 섞어 강한 불쾌감과 적대감을 드러내고 계십니다.
호모포비아 정신병이야 치료받아	성 소수자에 대한 혐오감을 드러내는 태도는 병적인 증세와 다름없으니 전문적인 상담과 인식 개선이 필요해 보입니다.
6언제든지 섹스하는 성자	성적인 관계에 대해 지나치게 개방적이거나 혹은 이를 왜곡되게 신성화하는 표현은 부적절해 보입니다.
저러면 죽음?	해당 상황이나 행위가 생명에 지장을 줄 만큼 위험한 결과를 초래하는지 의문스럽습니다.
다같이 상황따라 하는것이지 이게 기삿거리가 되나~~~	누구나 겪을 수 있는 보편적인 상황을 과도하게 포장하여 기사화하는 언론의 행태가 매우 무의미해 보입니다.
ㅋ 누가 파룸에 한번 올려봐라이기야 ^^	해당 내용을 특정 커뮤니티에 공개하여 여론의 반응을 살피거나 화두로 던져 보길 냉소적으로 권하고 계십니다.
꿀팁 웜리가또 조만간 카페알바하는 소설 쓰려했는데 잘 써먹겠다이기^느^	제시된 유용한 정보를 활용하여 창작물에 반영하겠다며 해당 커뮤니티의 말투를 빌려 감사 인사를 전하고 계십니다.
민주주의의 기본도 없고 삼권분리 개념도 없고 이 놈의 정부에서 원칙이란게 존재하기는 한건지.	국가 통치의 근간인 삼권분립 원칙을 무시하고 법적 원칙 없이 국정을 운영하는 행태에 대해 깊은 탄식과 분노를 느낍니다.
요번에 떡락하면 도박이든 아니든 가상화폐 구매할게. 코인쟁이들 과소 평가한 내가 판단을 잘못했다. 머스크 우주로 보내고 싶다. 세상을 망친 사업가.	가상자산 시장의 변동성을 예측하지 못한 과거를 자책하며, 시장을 혼란에 빠뜨린 특정 사업가에 대해 강한 반감을 드러냅니다.
결국 이렇게 트이타를 하게 되는구만.....할미보지 앵나온다 앵	결국 특정 소셜 미디어를 다시 이용하게 된 상황에 대해 자조 섞인 말투와 저속한 비유를 섞어 답답함을 표하고 계십니다.
후팔 내장탕 알탕 별거 다봐도 파스타 한접시 뚝딱인데 저건 진짜 꿈에 나올거같노	평소 혐오스러운 장면을 잘 견디는 편임에도 불구하고 현재의 이미지는 트라우마가 생길 정도로 매우 끔찍하고 거부감이 듭니다.
늙은 놈이 추하게 여자 존나게 밝히네미국 대통령 앞에서까지 한다는 말이“여자 없나요?”	외교적 결례를 불사하며 예의 없이 이성에 대한 집착을 드러내는 인물의 태도가 매우 상스럽고 부끄럽기 짝이 없습니다.
사카시도 해주네ㅋㅋㅋㅋㅋㅋ	구강 성교와 같은 자극적이고 부적절한 서비스를 제공한다는 사실에 대해 가벼운 어조로 놀라움을 표하고 계시군요.
멍청한건가 그럴듯한 변명을 해라 생리가 늦어진것도 아니고 출산 1주일 전에야 혹인줄 알았다고	태아의 존재를 종양으로 오인했다는 현실성 없는 주장을 변명으로 내세우는 인물의 지능과 정직함이 매우 의심스럽습니다.
족같지만 직장이라 욕 사용안하고 빙썅짓하거나 갈구는거밖엔 못 한다	업무 환경이 매우 불만족스러우나 직장이라는 제약 때문에 소극적이고 냉소적인 방식으로만 항의할 수밖에 없어 답답합니다.
걍 다 뒤졌으면	상황이 매우 안타깝고 해결 기미가 보이지 않아 극심한 회의감이 듭니다.
ㅋㅋㅋㄱㅋㅋㅋㅋㅋ정신승리오짐	어려운 상황 속에서도 본인에게 유리한 방향으로 생각하며 마음을 다스리는 모습이 인상적이군요.
시발 겉옷을 쳐 입으면 되지 별걸로 성차별	개인적인 의복 선택으로 해결될 수 있는 문제를 사회적 차별 담론으로 키우는 것이 비효율적이라고 생각합니다.
와...시발 말이안나오노.. 질문이 참	제시된 질문의 수준이나 의도가 너무나 당혹스러워 적절한 답변을 찾기조차 힘든 상황입니다.
저새끼들 그냥 지하에 클럽같은거 하루 빌려서 저 지랄하고 놀지 왜 굳이 저기에서 지랄일까	공공장소에서 타인에게 불편을 주기보다 적절한 전용 공간을 대여하여 활동하는 것이 타당해 보입니다.
죄다 지가 0선인거에 대한 변명밖에 없네.지도 세상 좋은사람처럼 행동해서 노원 공천은 3번이나 받았는데 당선이 안된거면 지가 문젠거지.사시패스못한 법무부 장관 / 0선 당대표 대체 뭐가 다른거냐	정치적 경력 부족에 대한 해명이 본질을 비껴가고 있으며, 반복된 낙선은 본인의 역량 문제임을 직시해야 한다는 비판적인 시각이군요.
뭔 조건만남을 찾냐 ㅋㅋㅋ걍 드라이브 할겸 수원평택역쪽가면 널린게 떡집인데 ㅉㅉ 하다못해 일산쪽 안마를 가겠다	부적절한 만남을 추구하기보다 차라리 다른 유흥 시설을 찾는 것이 낫겠다고 비꼬며 현재의 세태를 비판하고 계십니다.
절절함이 없으신가보네 확실히 유약해 체력달려서 당도 이끌질 못하는데 총선이나 대선땐 답도 없겠네	지도자로서의 절실함과 신체적 강인함이 부족해 보여 향후 중대한 선거에서 제 역할을 다할 수 있을지 심히 우려됩니다.
바벨로 내장 으깨고싶다	상대에 대해 참기 힘든 분노를 느끼며 신체적인 위해를 가하고 싶을 만큼 감정이 격앙된 상태이군요.
메일이 없는데 어케 메일을줘 씨바라	아이디나 주소 정보가 제공되지 않아 전자우편을 발송할 방법이 없으니 정확한 정보를 알려 주십시오.
지금 휘발유 사러 간다	극단적인 선택이나 행동을 암시하는 발언은 매우 위험하오니 차분하게 마음을 가라앉히시길 바랍니다.
이상성욕자	일반적인 범주에서 벗어난 성적 취향을 가진 분으로 보여 소통에 당혹감을 느낍니다.
자전거 관리해야겠노 시바거 자전거 훔쳐가면 1+1으로 새자전거가 온당껰ㅋㅋㅋㅋ	자전거 도난 사고에 대해 냉소적으로 반응하며, 보상 체계나 관리 부실 상황을 웃음으로 승화시키고 계시는군요.
코로나로 몰고 가지마라. 코로나 아니라도 이미 민심은 떠났다.	작금의 위기를 대외적 변수 탓으로만 돌리기에는 이미 대중의 신뢰가 크게 훼손된 상태라는 점을 지적합니다.
진 그만해라	더 이상의 무의미한 소모적 논쟁이나 행동은 중단해 주시길 정중히 요청합니다.
으아 성병저장소	위생 관리가 매우 불량하고 질병 노출 위협이 큰 공간으로 보여 접근하기가 꺼려집니다.
나라가 졷나 풍요로워져도 징징이들은 뭘 해도 안된다.위기 뒤에는 항상 기회가 오게 되어있음.기회가 올 때 준비가 되어있어야지 징징거리기만 하면 숟가락으로 떠서 입에 넣어주는 기회도 못잡음.	사회적 여건이 좋아져도 스스로 준비하지 않고 불평만 일삼는다면 찾아온 기회조차 잡을 수 없다는 점을 강조하며 성찰을 요구합니다.
ㄹㅇ 맨날 댓글에 안낳는다~~ 이지랄하는거 좆팔극험이노	출산을 거부하는 목소리가 반복되는 온라인상의 분위기에 대해 강한 불쾌감과 거부감을 느끼고 계십니다.
글쓴놈아 가가가가가가가가가가 이거는 뭔지 맞춰봐라	작성자에게 특정 언어의 유희적인 표현을 제시하며 그 의미를 파악해 보라고 가볍게 제안하고 계시는군요.
권리만 있지 과연 책임까지 지려할까요~ 관혼상제는 예법보다 지방이나 집안 역사에 맞추어 살도록 놔주세요...집안 대소사도 국가가 관리해야됩니까?	가정 내의 전통적인 관습에 공권력이 개입하는 것에 반대하며 자율적인 선택과 책임을 보장해 달라고 강력히 주장합니다.
만화에 나오는 싸이코박사 같다	학자로서의 모습이 일반적이지 않고 기괴하여 마치 창작물 속의 비정상적인 인물을 연상시킵니다.
옷 진짜 병신같이만들었네	의상의 디자인이나 마감 상태가 기대에 훨씬 미치지 못해 매우 실망스럽고 조잡해 보입니다.
이글에서 팩트는 지난해 1월 서울시에 없던 국장급자리 하나 만들고 그자리에 자기네 사람앉혔다는 거.	행정 조직 내에 불필요한 직책을 신설하고 측근을 임용한 것은 전형적인 인사 행정의 오용이라고 생각합니다.
난 진즉 없어진줄 알았는데 끈질기기도하노	과거의 낡은 관습이나 단체가 아직도 명맥을 유지하고 있는 모습이 매우 질기고 놀랍게 느껴집니다.
피시방 분위기가 맘에 안 들지 않냐	해당 영업소의 전반적인 분위기가 이용하기에 다소 불편하거나 정서적으로 맞지 않는 면이 있어 보입니다.
생긴게 원숭이 고릴라 계통이네..우웩 계욕질 나오네 토나올것같아	특정 인물의 외모를 영장류에 비유하며 원색적으로 비하하는 것은 매우 무례하고 불쾌한 언행입니다.
와 씨발ㅋㅋㅋㅋㅋㅋㅋㅋㅋㅋㅋㅋㅋㅋㅋㅋㅋㅋㅋㅋㅋㅋ	현재 벌어진 상황이 도저히 믿기지 않을 만큼 경악스럽고 어이가 없어 헛웃음이 나오네요.
맞으면 니가 어쩔건데 ㅋㅋㅋ	가정된 상황이 사실이라 하더라도 당신이 실질적으로 취할 수 있는 조치가 무엇인지 조소 섞인 의문을 제기합니다.
징하다 2년동안 저리살는데 아직도 눈치없게 그런걸 물어보노	오랜 시간 같은 상황을 겪었음에도 여전히 분위기를 파악하지 못하고 질문하는 태도가 매우 답답합니다.
2010년이면 나 중딩일때다 ㅅㅂ	벌써 십수 년 전의 일을 떠올리니 세월의 흐름이 빠름을 체감하며 묘한 기분이 드는군요.
좆대가리 막굴리는 병신새끼들은 감방에서 현실감각좀 길러야지	충동적이고 비상식적인 행동으로 사회에 해를 끼친 이들은 법적 격리 조치를 통해 자신의 잘못을 반성해야 합니다.
성희롱이나 쳐하는 좆거러지들이 스밍은 니비 ㅋㅋ	타인을 모욕하는 행위를 일삼으면서 팬 활동을 자칭하는 이들의 이중적인 태도가 매우 가증스럽습니다.
야 시발 얼마나 보상해달라고 해먹을라고 여기서버티는지 니들이아냐 ㅋㅋㅋ취재나와봤어?	현장의 실상을 제대로 파악하지 못한 채 보상금 문제만을 언급하는 시각에 대해 강한 불만과 항의를 표합니다.
어떤놈 잠은오냐??????	그런 잘못을 저지르고도 본인의 마음이 편안하여 잠을 이룰 수 있는지 상대의 양심에 묻고 싶습니다.
지들이 걸리면 피해자 다른 사람들이 걸리면 그들은 가해자 논리 우습네	본인에게는 관대하고 타인에게는 엄격한 이중 잣대의 논리가 매우 모순적이고 우스꽝스럽습니다.
아이들한테 머라한건 문제가 안되는데..먼 개지랄이냐..	교육적 차원에서의 훈육은 필요할 수 있으나 현재의 대응 방식은 도를 지나쳐 보여 매우 부적절합니다.
66결혼 열두 살에 한 대장님도 있는데 아동성범죄 시브럴거? 남편은 열두 살 연상이었다던데99 전통 유구하노	과거의 부적절한 관습을 언급하며 현재 발생한 아동 대상 범죄를 비꼬는 어투로 강하게 비판하고 계시는군요.
그건 여자애? 잘못이네ㅅㅂ어디서 수술을 받은거여? 받을꺼면 해외가서 받던갘ㅋㅋ	사고의 원인이 본인의 선택에 있음을 지적하며, 의료 기관 선정에 있어 더 신중했어야 함을 비꼽니다.
악마의 유혹에 넘어가셨노	본인의 도덕적 신념을 지키지 못하고 부적절한 유혹에 굴복하게 된 상황이 매우 안타깝습니다.
지랄하지마 등신아	사실과 다른 주장을 멈추어 주시고, 상식적이지 못한 언행은 삼가시길 바랍니다.
응 현실은 저런 애들 코스피 3000 돌파하고 부동산 폭등하고 손꾸락만 쪽쪽 팔다 한참 뒤에 꼭대기에 진입해서 설거지 당한다ㅋ	비관적인 태도로 기회를 놓치다 결국 자산 시장의 최고점에서 큰 손실을 보게 될 현실을 냉소적으로 예견합니다.
니들은 남자화장실에서 옷벗고 다리 벌려도 안벌려	상대 집단의 성적 매력이나 경쟁력을 극단적으로 비하하며 무례한 성적인 비유를 사용하고 계십니다.
쓰레기중에 쓰레기	인성이나 행동이 사회적으로 도저히 용납될 수 없을 만큼 극도로 타락한 상태입니다.
애기가 울 수도 있고 뛸 수도 있지 근데 그걸 방치하고 애가 그럴수도 있지라는 개소리하는 부모 문제	성장기 아이들의 행동은 이해할 수 있으나, 주변에 피해를 주는데도 방관하는 부모의 교육 태도가 문제입니다.
시발 ㅋㅋㅋㅋㅋ 이정도면 고도의 까 아님?	상황이 너무 과하여 오히려 대상을 조롱하려는 의도가 숨어 있는 것은 아닌지 의심스러울 정도군요.
니가왜난리임? 조용히신고를하든지	제3자로서 과도하게 개입하기보다는 절차에 따라 차분하게 공식적인 신고 조치를 취하시기 바랍니다.
유투브도 이쯤되면 문닫을때 된거 같다.	플랫폼 내의 유해한 콘텐츠와 무분별한 논쟁들이 심화되어 서비스의 지속 가능성에 회의감이 듭니다.
솔직히 저건 꼬추 잘못도 반이지 여기서 보지만 까는 새끼들 있냐?시발 발정나서 존나게 하다가 기집이 애 생겼다고 하니깐 현자 타임 와서 좆까하는거지	책임 없는 성적 행동의 결과로 발생한 문제에 대해 남녀 모두 공동의 책임이 있음을 원색적인 어투로 강조합니다.
대단하다. 400명 이상을 내마음대로 조종하고 그룹 세우고 유죄받아도 계속 옹호 보호 해주고 이런 믿음받는것도 한편으로는 징그럽게 대단하네. 저것을 믿는 사람들 .... 휴거날이 또 와야 하는데 저것들 한번에 다갖이 가라고..	맹목적인 추종과 광신적 집단행동이 자아내는 기괴한 결속력에 대해 강한 전율과 혐오를 동시에 느끼고 있습니다.
그냥 꼬추 자른다는 조건하에 군대 면제시켜줘라	병역 의무 면제에 대해 극단적이고 신체적인 조건을 거론하며 현재의 보상 체계를 강력하게 풍자하고 계십니다.
닭그네..하.....	과거 통수권자의 실망스러운 행보를 떠올리니 깊은 탄식과 함께 말로 다 표현 못 할 안타까움이 느껴집니다.
그이상 더 성장했다가? 앞으로 더 큰 일 낼 사람들이군.	현재의 잠재력을 볼 때 향후 사회적으로 더 큰 파장을 일으키거나 훌륭한 성과를 낼 인물들로 기대됩니다.
하 갈수록 사이비들이 느는것이	비상식적인 교리와 행태를 보이는 집단들이 사회 곳곳에 확산되는 현실이 매우 우려스럽고 답답합니다.
리볼트 더하우스오브더데드 안하는 호구새끼 없지	과거 유명했던 게임들을 아직 경험해 보지 못한 분들은 드물 것이라며 친숙한 문화 향유를 언급하고 계십니다.
오키나와 시발	오키나와와 관련된 특수한 상황이나 사건에 대해 매우 불쾌하고 당혹스러운 감정을 숨기기 어렵군요.
민주화는 개뿔~공산화 종북 좌익운동!	해당 사회 운동의 본질이 민주주의를 지향하기보다 편향된 이념 확산에 치우쳐 있다고 강하게 주장합니다.
권력형 비리??? 이미 판결문 써놓고 기사쓰는 분위기네.	수사나 재판의 확정 전부터 이미 유죄를 단정 짓고 보도하는 언론의 태도가 매우 편파적이라고 느낍니다.
조주빈이 손석희 언급하고 언론 잠잠해진것도 존나 웃김 ㅋㅋㅋ 만약 조주빈이가 오세훈이나 강용석을 언급했어도 저렇게 잠잠해졌을까? ㅋㅋㅋㅋ	유명 인사 언급 여부에 따라 언론의 취재 태도가 달라지는 선택적 보도 행태가 매우 공정하지 못하고 의문스럽습니다.
저게 초등생 대상 강사가 할짓인가? 아이들한테 편협한 생각을 강요하네	교육자로서 중립을 지키지 못하고 아직 가치관이 정립되지 않은 아이들에게 일방적인 생각을 주입하는 것은 매우 위험합니다.
아직도 양심없이 설치네 미친것...,,,니 인생이 불쌍하다	잘못을 저지르고도 당당하게 활동하는 모습에서 인격적 결함이 느껴지며 그런 삶의 태도가 참으로 가련하게 느껴집니다.
다음정권은 무조건 가져 와야 한다저번 정권 광우뻥파동 으로 아무것도 못하고 그나마 레가께서 비정상의정상화를 부르짖으시며 자리가 잡혀가는데 다음정권 뺏길경우 도로아미타블 생각하기도 싫다	차기 정권 창출의 필요성을 강조하며 과거의 혼란이 되풀이되지 않기를 바라는 간절한 정치적 소망을 나타냅니다.
좆나 1000만 대작 나올듯ㅋ기	작품의 완성도와 대중성을 고려할 때 관객 수 천만 명을 돌파할 만한 엄청난 흥행이 예상됩니다.
교묘한 성추행 오지고요	상대방의 의사에 반해 은밀하고도 불쾌하게 이루어지는 성적 접촉 시도가 매우 혐오스럽고 비도덕적입니다.
얘 아직 정치하나 ㅋㅋㅋㅋ	해당 인물의 현재 활동 소식이 뜸한 것으로 보아 아직도 정계에서 역할을 수행하고 있는지 궁금합니다.
병1신인가?제주도를 왜가지?ㅋㅋ	관광 목적이나 시기가 현재 상황과 맞지 않아 제주도를 방문하려는 계획이 매우 비상식적으로 느껴집니다.
존나 못싸우네 ㅋㅋㅋㅋㅋㅋㅋ 저정도면 186/79의 날렵한 체형의 내가 두드려 패겠다 ㅋㅋㅋㅋㅋ	상대방의 싸움 실력을 조롱하며 본인의 신체 조건을 내세워 압도할 수 있음을 과시하고 계시는군요.
너그도 뭉가처럼 쇼 마니 하네..불쌍한 집단!!	실질적인 변화보다 보여주기식 행보에 치중하는 집단의 태도가 진정성 없어 보이고 안타깝게 느껴집니다.
대통령병 걸린 제2의 개대중	특정 정치인에 비유하며 권력욕에만 사로잡혀 대권만을 추구하는 인물을 비하적으로 비판하고 계십니다.
시발 존나 지금 알았노 ㅋㅋㅋㅋ	그동안 전혀 인지하지 못했던 놀라운 사실을 뒤늦게 깨닫게 되어 매우 충격적이고 당혹스럽네요.
죽고싶냐?	상대방의 언행이 매우 도를 지나쳐 생명에 위협을 느낄 정도의 강한 경고를 보내고 싶을 만큼 분노가 치밉니다.
젠더특보라면서 성범죄 가해자 새끼랑 대책회의를 함 ㅋㅋㅋㅋㅋ 차라리 관노 상납하는 포주특보라고 하지 그러냐? ㅋㅋ	성 평등 가치를 실현해야 할 직책자가 가해자와 논의하는 행태는 본래 취지를 무색하게 만드는 모순적 행보입니다.
혼인제도가 사라져야한다. 남자는 씨를 뿌릴 권리 여자는 아이 갖을 권리. 육아는 국가에서. 끝. 아마 인구 음청 불어날걸??	전통적인 혼인 제도를 전면 개편하고 국가 주도의 양육 인프라를 구축하는 것이 인구 문제 해결의 열쇠라고 주장합니다.
모국방문 지원을 왜 해줘야하냐 ㅋㅋㅋㅋㅋ말같지도 않는.소리하네	특정 집단에 대한 과도한 복지 혜택이나 세금 지원 명분이 부족하다고 느끼며 강력한 불만을 표합니다.
크으 맞노 알량한 지배심 뭉개놔야하노	타인을 통제하려는 편협한 권력 의지를 완전히 꺾어버려야 한다는 의견에 전적으로 공감합니다.
첫추행에 반박하고 부서이동하지않았는지 4년이라는. 그긴. 시간을. 왜 참고 곁에 있는었는지 ㅡ그거부터 알고싶다ㅡ	피해 사실이 발생한 직후 즉각적인 대응을 하지 못하고 오랜 시간 상황을 인내할 수밖에 없었던 배경이 의문스럽습니다.
육개장 = 500원 = 재기행 열차표 가격	타인의 고인된 상태를 비하하고 죽음의 값을 가볍게 매기는 언행은 인간의 존엄성을 훼손하는 부적절한 표현입니다.
더운게 유일한 자랑인 새끼들인데... ㅠㅠ	특정 지역이나 대상의 열악한 환경적 특징을 유일한 특징으로 희화화하며 조롱하는 태도가 안타깝습니다.
자얼글로 알바 가능한거노? 양심다 뒤졋노ㅔ	외모가 영업 활동에 적합하지 않은 수준임에도 이를 의식하지 않는 태도가 매우 뻔뻔해 보여 실망스럽습니다.
내가 저런사람으로 안태어나서 진심 정말 다행이다 나같음 ㅈ ㅏㅅㅏㄹ 할텐데 사람을 사람으로 보긴할까? 저분들은 분류해서 볼듯한데 거기서도 급을 나누겠지? 저런생각을 항상 달고사는거 아니여 정신병걸려서 못살듯	타인을 차별하고 급을 나누는 왜곡된 가치관을 가진 이들의 삶이 얼마나 불행할지 짐작하며 안도와 우려를 동시에 느낍니다.
편집한게 무슨 씨발 80년대 영화포스터같네	영상이나 이미지의 편집 수준이 너무 낙후되어 마치 수십 년 전의 조잡한 디자인을 보는 것 같아 당혹스럽습니다.
진짜 시발 나만 안대주는 이유가 대체 뭐노 이기	타인과 원만한 이성 관계를 맺지 못하는 원인이 본인에게 있음을 인지하지 못한 채 세상에 대한 불만을 드러내고 계십니다.
씨바 뭐하고 있냐!!!	현재 대응이 너무나 미온적이고 느려 답답함의 극치를 느끼며 즉각적이고 강력한 조치를 촉구합니다.
쟤네 인과관계라는말 모르는거 아니냐?	사건의 원인과 결과를 올바르게 연결 짓지 못하고 논리적 비약을 일삼는 상대의 사고방식이 의문스럽습니다.
팩폭오졌다 ㅋㅋㅋ	반박할 수 없는 사실로 상대의 허점을 신랄하게 지적하는 모습이 매우 통쾌하고 인상적이군요.
저건 이재용부회장 집행유예가 부당하다는 글이 아니고내 남편 삼성다닌다고 자랑하는 글이지덤으로 그래도 나는 깨어있다 이것도 자랑하고	사회 정의를 외치는 듯하나 실은 본인의 안위와 소문을 과시하려는 의도가 엿보여 진정성이 느껴지지 않습니다.
글씨도 읽을 줄 모르고 왜 사노 재기해라익이	문해력 부족을 조롱하며 삶의 가치를 부정하는 극단적인 언사를 사용하는 것은 인격 모독에 해당하는 무례한 태도입니다.
일단 보내 ㅅㅂㅋㅋㅋㅋㅋㅋㅋㅋㅋ	후일의 결과는 차치하고 일단 실행에 옮겨 버리는 상황이 매우 황당하면서도 실소가 터져 나오네요.
인생 정리하시요. 무슨 낮으로 당신 가정을 이끌것이며, 대통령과 당신을 지금 그자리에 있게한 당은 무슨 염치로... 결단이 필요하다고 보이지 않소.	사회적 물의를 일으킨 책임자로서 자택 사퇴나 용퇴를 통해 모든 지위에서 물러나는 결단이 시급해 보입니다.
핑크색 팔뚝만한거 보면 꼴리긴 하노	특정 색상이나 신체 부위에 대해 성적인 흥분과 관심을 강하게 느끼며 저속한 어조로 이를 표현하고 계십니다.
꼬우면 끄지든가	현재의 상황이나 조건이 본인의 마음에 들지 않는다면 불평 대신 자당의 활동을 중단하고 떠나 주시길 바랍니다.
왜 짜 르고ㅡㅡ녀자하곷사니ㅡㅡ내가헤갈 린다ㅡㅡㅡㅋ	성 정체성의 급격한 변화나 혼란스러운 모습을 보며 상대의 의도와 현 상황을 이해하기 매우 어렵고 당혹스럽습니다.
ㅋㅋㅋ보지꾸러기노 ㅋㅋㅋㅋ 갓치는 다커노 애노익잌ㅋㅋㅋㅋ	여성 집단을 비하하는 은어를 사용하며 상대의 상황을 조롱하려는 태도가 매우 저속하고 부적절해 보입니다.
기왕 좆된거 한개 더 좆된다고 뭐 있겠니? 거하게 조지는것도 나쁘지 않음. 돌아올 수 없을지 모르지만	이미 상황이 악화된 만큼 더 과감한 돌파를 시도해 보려는 무모하면서도 절박한 심경이 느껴집니다.
영상구독하는놈도 공범	불법 촬영물이나 유해한 콘텐츠를 시청하고 향유하는 것 또한 범죄 행위에 조력하는 것과 다를 바 없습니다.
저사람 가세연에서 봤는데 언제 쫒겨남?ㅋㅋㅋㅋㅋㅋㅋㅋㅋㅋ	특정 정치 평론 채널에서 활동하던 인물의 행보가 어떻게 변했는지 궁금해하며 그의 이탈 시점을 묻고 계십니다.
음식가지고 부심좀 그만부려 씨발! 이래서 국제사회에서 김치부심 부리지!	특정 음식에 대한 과도한 자부심이 오히려 타인이나 타문화에 대한 무례함으로 비치는 세태에 대해 강한 불만을 표합니다.
지 꽁섹해준거 모부가 다 알고있든? 그거랑 같은거다ㅋㅋㅋ 나쁜거인걸 아니까 안들키게 꽁꽁 숨겨놓고 조용히 다니는거지	본인의 부적절한 행위를 숨기려는 이중적인 태도를 지적하며 도덕적 우월감을 내세우는 시선이 매우 날카롭습니다.
저기요.. 차별 의식은 니네가 더 심해요.. 여기는 타인종 상대로 피날정도로 패지도 않고 성소수자 상대로 그러지도 않아요.	해외의 인권 의식을 비판하며 국내 사회가 상대적으로 더 관용적이고 평화롭다는 점을 강조하며 항변하고 계십니다.
일단 당선되고 권력으로 짖밟으면 되노 그래서 권력이 필요하노	권력을 목적 달성을 위한 억압의 수단으로만 여기는 비민주적인 발상과 사고방식이 매우 우려스럽습니다.
이게 주작이 아니라고?씨발...	이게 조작된 상황이 아니라는 사실에 깊은 충격과 당혹감을 느낍니다.
왜 다녀. 바보야?	그곳에 방문하는 이유에 대해 합리적으로 이해하기 어렵습니다. 신중하게 생각해보시길 바랍니다.
그냥 재기시켜뿌리면 안되는거노?	해당 사안이나 인물을 사회적으로 완전히 배제하거나 극단적인 결정을 내릴 수는 없는 것인지 의문스럽습니다.
ㅅㅂ 디져라...	현재 상황이 너무나 고통스럽고 화가 나서 차라리 모든 것이 멈췄으면 하는 심정입니다.
어이 강씨! 이쁘면 그냥 델구가서 즐겁게 해주면 뒷탈 없어.	강 선생님, 상대방의 외모를 칭찬하며 호의를 베풀어 원만하게 인연을 맺어 보시길 조심스럽게 권합니다.
저래놓고 대구경북 몰표라고 존나 욕함 ㅋㅋㅋㅋ	특정 지역의 투표 결과에 대해 비판하면서 정작 상충하는 행동을 하는 모습이 매우 모순적으로 느껴집니다.
저렇게 분석해서 글 올리는 놈들 거진 알바임 저거 하라고 각종 협회 시민단체에 돈 엄청 뿌리잖아	치밀한 분석글 배후에 특정 단체의 금전적 지원을 받는 여론 조작 세력이 있는 것은 아닌지 강하게 의심됩니다.
저 기자는 참 기사를 편파적으로 쓴다.자기 입맛대로 쓰군 ㅉㅉ	해당 기자는 보도의 중립성을 잃고 본인의 주관적인 견해에 치우쳐 기사를 작성하는 것 같아 실망스럽습니다.
요즘에 이상한 애들 정말 많아	최근 우리 사회에 상식적이지 않은 태도를 보이는 이들이 부쩍 늘어난 것 같아 당혹스럽습니다.
잘모르는걸 왜 자꾸 지껄여?	정확한 사실 관계를 파약하지 못한 상태에서 성급하게 의견을 개진하는 것은 삼가 주시기 바랍니다.
십자가에 매달아 사형	저지른 잘못의 엄중함을 고려할 때 가장 강력하고 상징적인 법적 처벌이 내려져야 한다고 생각합니다.
느그아빠한테도 큰엄마가 반말할꺼다 불편해 하지마라	가정 내의 친소 관계에 따라 반말을 사용하는 문화적 특성이 있을 수 있으니 너무 민감하게 반응하지 않으셔도 됩니다.
글내용을 보니 핵교 때려치고 배달하길 잘한듯하다	현재 교육 현장의 문제점을 보니 학업을 중단하고 실무 전선에 뛰어든 본인의 선택이 오히려 현명하게 느껴지는군요.
저새끼들 진짜 죽여버리고싶다	해당 집단의 행동이 인내심의 한계를 넘어서서 주체하기 힘들 정도의 강한 분노와 살의를 느낍니다.
갈수록 씹창되가는 나라ㅋㅋㅋㅋㅋㅋㅋㅋㅋ	국가 전반의 상황이 나날이 악화되는 현상을 보며 자조 섞인 웃음과 함께 깊은 우려를 금치 못하겠습니다.
ㅗㅜㅑㅅㅂ3ㅂ	상황이나 대상이 주는 시각적인 자극이나 충격이 매우 크고 당혹스러워서 할 말을 잃을 정도군요.
야이 개새끼야푸틴이랑 진핑이가 이글보고 눈치깟잖아 아오 ㅅㅂ	작성하신 정보가 대외적으로 민감하게 작용하여 국가 전략에 차질을 빚게 될까 봐 매우 화가 나고 걱정됩니다.
저거 생기면 또라이들 범죄 엄청 일어날텐데, 여성전용아파트는 여성 스스로 지키나?	여성 전용 주거 공간의 신설이 오히려 범죄의 표적이 되지는 않을지, 실효성 있는 치안 대책이 마련되어 있는지 우려됩니다.
지금 나라 씹망하고 있는거 체감이 안되는 빡대가리 새끼들 아직도 많은 거 같은데 ㅋㅋㅋ 한 10년 20년 지나면 진짜 볼만할거다. 강건너 불구경 개꿀일듯 ㅋㅋ	국가 위기 상황을 인지하지 못하는 이들이 답답하며, 향후 닥칠 파국을 방관자적 시선으로 냉소하며 지켜보겠습니다.
좆같이 생겼네 진짜 목이 좆기둥처럼 생겨서 하는말임 ㅎㅎ	상대의 신체적 특징에 대해 매우 무례하고 저속한 비유를 사용하여 외모를 비하하는 것은 삼가야 할 언행입니다.
아시발ㅋㅋㅋㅋㅋㅋㅋㅋㅋㅋㅋㅋㅋㅋㅋㅋㅋㅋㅋㅋㅋㅋㅋㅋㅋㅋㅋㅋㅋㅋㅋㅋㅋㅋㅋㅋㅋㅋㅋㅋ	현재 상황이 도저히 믿기지 않을 정도로 황당하고 어이가 없어서 웃음밖에 나오지 않는군요.
보력 한번을 안오냐 혼자 아이디 돌리기 앵나 힘드노 좆팔	동료들의 지원 없이 홀로 여론 대응 활동을 이어가는 것이 체력적으로나 심리적으로 너무나 고통스럽고 지칩니다.
ㅅㅂ 드립이아니라 진짜였네	가벼운 농담이나 소문인 줄로만 알았던 일이 실제 사실로 밝혀져 매우 경악스럽고 충격적입니다.
그래 알았으니 너네 비리도 좀 밝혀라 맨날 전이야기만 하고 너네는 깨긋하냐 ?	과거의 문제만 들추기보다 현재 본인들이 가진 부패와 비리에 대해서도 투명하게 공개하고 성찰할 것을 강력히 촉구합니다.
왜 저런걸 찍어서 올리는것같냐?애새끼도 있겠다 우리들 뒷바라지 해줄 남자 찾을라고 그러는거지	해당 영상 배포의 의도가 본인의 양육 환경을 개선하기 위한 도구로 이성을 활용하려는 것은 아닌지 의문스럽습니다.
정문 길 건너 약국 뒤에 황제뒷고기 맞냐5분 준다대답해라	특정 장소를 거론하며 상대방에게 시간적 압박을 주어 답변을 강요하는 행위는 매우 위협적으로 느껴질 수 있습니다.
뭐냐 저거 진짜냐	눈앞에 보이는 광경이 상식적으로 이해하기 힘들 정도로 기이해서 사실 여부를 조심스럽게 묻고 싶네요.
그냥 반대목소리 내라는 존나 단순한 글을 왜 이렇게 장황하게 써갈겨놨냐	반대 의견을 표명하라는 핵심 내용에 비해 글의 구성이 지나치게 수사적이고 장황하여 가독성이 떨어집니다.
어두운데 우굴우굴 모여있다가 불켜면 사사삭 사라지는 바퀴벌레가 따로 없네	음지에서 활동하다가 진실이 드러나면 비겁하게 숨어버리는 집단의 행태가 매우 치졸하고 혐오스럽습니다.
어....이건.....진짜....아닌데.....	현재 벌어지고 있는 상황이나 결정이 상식과 도리에 크게 어긋나 보여 도저히 받아들이기 어렵습니다.
80년대는 니기미 ㅎㅎㅎ 좆도 모르면 그냥 닥쳐~~~	과거 역사에 대해 충분한 지식도 없으면서 함부로 아는 척하는 태도는 눈살을 찌푸리게 하니 자중하시기 바랍니다.
솔찍히 중동 부자년 이랑 결혼 해도 나쁘지 않을거 같다 옵션이 돈이니 시발 ㅎㅎ	경제적 풍요를 누릴 수 있다면 타 문화권의 배우자와 혼인하는 것도 현실적인 대안이 될 수 있겠다고 생각합니다.
소돔과 고모라가 따로 없네 양쪽다 폭탄 터트려서 없애버리면 클린 서울	사회적 부패와 타락이 극에 달한 현상을 지적하며, 극단적인 정화 조치를 통해서라도 질서가 회복되길 바라는 마음입니다.
가까운 한중일 건축양식만 봐도 제일 구리노. 기안내 개오진다익이	주변 국가들의 건축미와 비교했을 때 우리나라의 현대 건축 양식이 상대적으로 낙후되고 세련되지 못해 아쉽습니다.
구웨에에에엥엑 와꾸가 하나같이 다 똑같노	등장 인물들의 외모가 개성 없이 획일화되어 있고 미적으로도 조화롭지 못해 시각적인 불쾌감이 느껴질 정도군요.
말들 드럽게 안들어 진짜	정중한 요청이나 규칙을 반복적으로 무시하고 본인들의 고집대로만 행동하는 태도가 너무나도 답답합니다.
이새끼 성추행 발언 존나 했구만 ㅋㅋㅋ그러니까 지가 쓴 댓글에 대해서는 언급안하지	해당 인물은 본인의 과거 부적절한 언행에 대해서는 침묵한 채 타인만을 비판하는 위선적인 이중 잣대를 보이고 있습니다.
응원합니다로 했어야지 빨간색으로그래야 제대로 멕이는 건데ㅋㅋㅋ	상대방을 더 효과적으로 비꼬거나 당혹스럽게 하려면 반어법적인 표현과 시각적 효과를 활용했어야 한다고 조언합니다.
아 보기싫다	현재 노출되는 콘텐츠나 상황이 정서적으로 매우 거부감이 들어 더 이상 지켜보고 싶지 않은 심정입니다.
시발 존나웃기넼ㅋㅋㅋㅋㅋㅋㅋㅋㅋㅋㅋㅋㅋㅋㅋㅋㅋㅋㅋㅋㅋㅋㅋㅋ	너무나도 황당하고 기발한 상황이라 웃음을 참기 힘들 정도로 즐거우면서도 어이가 없네요.
홈쇼핑에서 젤 많이 파는게 프라다 짱개명품이다 디자인도 발전없고 다 중국생산 흔한 가방일뿐 특히 너무 칙칙해 요즘 스탈 아님 효도 했는데 이런 소리해서 미안해	선물을 해드리고 싶은 마음은 굴뚝같으나, 현재 유통되는 특정 브랜드 제품의 질이나 디자인이 기대에 미치지 못해 아쉽습니다.
압구정에 광림교회랑 바로 옆에 압구정 성당 보면서 저 땅만 팔아도 도대체 얼마일까 가늠이 안가더라 ㅅㅂ	도심 요지의 막대한 부동산 자본이 특정 종교 기관에 집중되어 있는 현실을 보며 자본주의 사회의 단면을 체감합니다.
그래서 이익은 또 투명해졌노? ㅋㅋㅋㅋㄱㅋ	운영 방식이 개선되었다고 주장하지만 정작 금전적인 이익 배분 과정이 공정한지에 대해서는 여전히 의문스럽습니다.
저게 축제라면 서울시는 포르노 축제도 허용해야지..	저속한 행사를 문화 축제로 승인한 서울시의 결정은 행정의 일관성과 도덕적 기준을 상실한 행위라고 비판합니다.
똥이 묻었노ㅋㅋㅋㅋ	불결한 이물질이 묻어 있는 모습이 매우 지저분하고 우스꽝스러워 눈살이 찌푸려지는군요.
조회수올릴려고 별짓 다한다	콘텐츠의 질적 개선보다 자극적인 소재로 대중의 관심을 끄는 데만 급급한 모습이 눈에 보여 한심합니다.
원하지 않는 성매매업 종사자는 구제해주는 게 좋지만 이 놈의 나라는 상식을 지키며 사는 사람이 늘 송해본단 말이죠. 부동산이든 뭐든..	취약 계층 지원의 필요성에는 공감하나 성실하게 법을 지키는 시민들이 상대적 박탈감을 느끼지 않도록 형평성 있는 정책이 필요합니다.
뭐노 일부로 면상늘려놓은거 아니노? ㅋㅋㅋ아니면 뭐 저리 빻았노?	사진 속 인물의 외모가 비정상적으로 왜곡되어 기괴하게 느껴질 정도로 조화롭지 못해 그 실제 모습이 의문스럽습니다.
피해자가 고소도 하기전 젠더에게 고소할거란 사실을 알려준 인간 반드시 찾아서 처벌해야한다	기밀 사항인 고소 계획을 외부로 유출하여 수사를 방해한 조력자를 반드시 검거하여 엄벌에 처해야 마땅합니다.
일단 선처같은거 해주지마라 인실좆	범죄 사실에 대해 관용을 베풀기보다는 정당한 법적 처벌과 책임을 통해 정의를 실현해 주길 강력히 희망합니다.
평등같은거 좆도 관심없고 지 손해본거 생각밖에 안함. 평등하지 않은건 지들도 아는데 이권놓칠까봐 입터는거	그들의 주장은 보편적 권익을 위함이 아니라 오직 본인들의 기득권을 지키기 위한 이기적인 변명에 불과해 보입니다.
시발 누가 노짱으로좀 달려라	고인의 이미지를 사용하여 자극적인 게시물을 작성함으로써 여론의 관심을 끌어내 보라고 무책임하게 부추기고 계십니다.
여자껀 타이트하게 줄이면 색기뒤질거같은대...벗길땐 지금교복보다 더꼴릴듯....남자껀 별지랄을다해도 칼라풀 머슴같을듯	교복 디자인 변경에 대해 성적인 호기심과 편견을 바탕으로 저속한 품평을 늘어놓는 것은 매우 부적절한 태도입니다.
ㅂㅈ냄새 정도는 좀 맡게 해줘라...ㅅㅅ도 못하게 하면서냄새도 못 맡게 하노...	상대에 대해 성적인 욕구를 강요하며 비인격적인 요구를 서슴지 않는 태도는 성폭력적이며 매우 혐오스럽습니다.
씨발;;사람이냐?	인간으로서 지켜야 할 최소한의 기본 권리나 윤리조차 저버린 행동이라 인성 자체가 의심스럽고 경악스럽습니다.
우상호ㅋㅋㅋㅋㅋㅋ 아직 시장에 당선되지 않아 모른다 ㅋㅋㅋㅋㅋㄱㅋ	현안에 대해 구체적인 답변 대신 책임 회피성 발언으로 일관하는 후보자의 태도가 매우 미숙하고 실망스럽습니다.
어그로네씨발	고의적으로 다른 사람들의 감정을 자극하여 소모적인 논쟁을 유도하려는 의도가 뻔히 보여 매우 불쾌합니다.
아니 시발 의무도 안질거면서 권리 달라는 병신같은 날강도 마인드가 어딧냐 존나 어이털리네	사회적 책임이나 국민의 의무는 회피하면서 혜택만을 누리려는 이기적인 주장은 공정 사회에서 용납될 수 없습니다.
병신3으로 보이노	현재 보여 주시는 세 명의 모습이 모두 상식에 어긋나고 어리석어 보여 소통의 의지를 잃게 만드네요.
너희들이나 잘하세요	자신들의 허물은 돌아보지 않은 채 타인에게만 잣대를 들이대지 말고 본인들의 언행부터 바로잡으시기 바랍니다.
좇미개;;	문화 수준이나 사회적 인지 능력이 시대 흐름에 한참 뒤떨어진 매우 낙후된 모습으로 보여 실망이 큽니다.
너 하나가면 전국민이 행복.... 추종자 빼고	해당 인물이 사회적 영향력을 상실하거나 자리를 물러난다면 대다수의 국민이 환영하고 사회 분위기가 정화될 것입니다.
겉과속이다른 사람들~	일반인 앞에서는 고결한 척하나 뒤에서는 부적절한 행태를 보이는 이들의 위선적인 면모를 꼬집고 계시는군요.
씹 파오후네 ㅋㅋㅋ	과체중인 신체적 특징을 비하적 은어로 조롱하며 인격을 폄하하는 것은 매우 예의 없는 행동입니다.
인류의 퇴보야 이건	현재 벌어지는 현상들이 문명 사회의 보편적 가치를 훼손하고 과거로 회귀하는 듯해 깊은 회의감이 느껴집니다.
와 씨발 저 우비 진짜 ㅋㅋ 개씨팔 좆같지 저거 ㅋㅋ	군용 우의의 낮은 품질과 사용 시의 극심한 불편함을 떠올리니 다시 생각해도 매우 불쾌하고 짜증이 밀려오는군요.
이 기사가 어제 저녁 부터 오늘 하루종일 메인에 떠있을 뉴스인가? 뭣이 중헌디?	사회적으로 더 시급하고 중대한 현안들이 많음에도 가벼운 뉴스만 지속적으로 노출하는 언론의 편집 방식이 불만스럽습니다.
서로 폭로전만 하지말고 정식으로 고소하고 법적으로 책임져라. 그러면 둘중 하나는 뒤지겠지. 아니면 둘다 뒤지든가.	감정적인 공방 대신 사법 절차를 통해 시비비비를 명확히 가리고, 그 결과에 따라 엄중한 책임을 지길 바랍니다.
니가 문제다..	벌어지고 있는 여러 갈등의 근본 원인은 외부가 아닌 바로 본인에게 있음을 인지하고 자숙하시기 바랍니다.
ㅋㅋ 그래 연봉따지는거 인정한다 그럼 너는 뭘 그리 갖추었길래 그런식으로 따지냐 ㅋㅋ 꼭 좃도 없는년들이 따질껀 존나 잘따지네 ㅋㅋ	이성에게 높은 조건을 요구하기 전 본인의 자격과 준비 상태를 객관적으로 돌아보는 태도가 선행되어야 함을 강조합니다.
쟤네 티비출연이나 안 시켰으면 꼴도 보기 싫음	사회적 논란을 일으킨 인물들이 대중 매체에 지속적으로 노출되어 피로감을 유발하는 것에 대해 강한 거부감을 표합니다.
이정도면 정신병 아니냐? 기자야 치료받아라.	특정 사안에 대해 집착하거나 왜곡된 보도를 남발하는 기자의 심리 상태가 상식적이지 않아 보여 깊이 우려됩니다.
틀린말 아닌데 그말을 너같은 애들이 하면 설득력이 당연히없는거지..	제시하신 의견 자체는 타당할지라도 평소 보여 주신 부적절한 행실로 인해 그 진정성을 믿어주기 어렵습니다.
이미 전국민을 상대로 세뇌가 진행 중이었구나	특정 이념이나 왜곡된 정보가 사회 전반에 조직적으로 유포되어 대중의 판단력을 흐리고 있는 현상이 매우 소름 돋습니다.
요즘 북한이 돈도 없으면서 엄청난 돈이 들어가는 무기개발에 개발한 무기들이 대부분 한국무기와 모양,기능,체계가 너무나도 닮아서 놀라웠는데 매국노집단이 있었구나!	적대 세력의 군사 기술이 급격히 발전한 배경에 국내 군사 기밀이 유출되었을 가능성을 제기하며 국가 안보 위협을 우려합니다.
가독성 ㅆㅎㅌㅊ	글의 구성이나 문장이 매우 무질서하여 작성자가 전달하고자 하는 핵심 내용을 파악하기가 너무나 어렵습니다.
요즘 헬스 약물 어쩌고 그거 남성호르몬 이슈되는거 반대로 여성호르몬 처맞는게 아닐까 의심되는 멸치 투블럭 뿔테충들 극혐 그런 놈들은 군대 10년 끌려가도 아가리 닫고 있을놈들임	신체적 특징과 외양을 근거로 남성성을 비하하고 이들이 국방의 의무에 대해 수동적인 태도를 보일 것이라며 폄하하고 계십니다.
또라이 만난적 있었는데 내가 더 또라이였음 ㅋㅋㅋㅋㅋㅋ 머피소 낫꿘때매 한창 낫들고 다니던 시기였다이기.. (먼산)	과거의 험악했던 사회 분위기를 회상하며 생존을 위해 강하게 대응해야만 했던 본인의 무용담을 묘한 감회와 함께 이야기하고 계시는군요.
인권팔이 지겹...	인권 보호라는 숭고한 가치를 본인들의 사적 이익이나 정치적 목적을 위해 활용하는 행태에 대해 깊은 피로감을 느낍니다.
내 전남충 얘기노 후팔놈	과거 사귀었던 남성과의 좋지 않았던 기억을 떠올리며 그에 대해 강한 적대감과 비하 섞인 분노를 표출하고 계시는군요.
관종일세~~~잊을만하면 나오는거 보니~~추하다 윈하는게 뭘까?	대중의 관심을 끌기 위해 반복적으로 무리한 언행을 일삼는 인물의 행태가 매우 상스럽고 눈살이 찌푸려집니다.
심지어 참대학 다니는 사람이노 ㅋㅋㅋㅋㅋ그래서 더 발작하는 게 분명하노 좆병신	특정 고등 교육 기관 소속임을 언급하며 그 자부심이 훼손된 것에 대해 과도하게 예민한 반응을 보이는 모습이 매우 어리석어 보입니다.
이런 폐기물이 일베쳐오고 랩업하고 ㅋㅋ	도덕적으로 가치 없는 게시물이 특정 커뮤니티에서 인기 글로 선정되는 현실이 온라인 생태계의 부작용을 단적으로 보여 줍니다.
너 여권보여달라고 했으면 좆될뻔했네	상대방의 신분을 확인하려는 시도가 자칫 큰 문제나 법적 분쟁으로 번질 수 있었던 아찔한 상황이었음을 지적합니다.
인간이 아니지 저것들은	도저히 사람으로서 할 수 없는 잔인하거나 부도덕한 행동을 저질렀기에 인격을 부정하고 싶을 만큼 분노스럽습니다.
카더라 좆까 씨팔아	근거 없는 소문이나 추측성 정보를 사실인 양 유포하며 대중을 선동하는 행위는 즉각 중단되어야 마땅합니다.
야 댓글 재기주지마 존나 티나노 ㅋㅋㅋㅋㅋㅋ이때싶 정의당 까면서 표몰이 하려고 하는 거	특정 정당에 유리한 여론을 조성하기 위해 타 정당을 비하하는 댓글 조작 행태가 너무나 노골적이고 치졸해 보입니다.
솔직히너무냄새남...	대상에서 발생하는 불쾌한 냄새가 신체적으로 견디기 힘든 수준이라 가까이하기가 매우 꺼려집니다.
문법 공부 부터 다시좀	기초적인 문법 규칙조차 지키지 못한 문장이라 의미 전달이 되지 않으니 어학 능력을 먼저 배양하시기 바랍니다.
ㄹㄹ 살아있는 공해임	해당 존재가 우리 공동체나 환경에 하등의 이득 없이 오직 해로운 영향력만 끼치고 있어 매우 고통스럽습니다.
북괴 두만강쪽도 저런 시체 넘쳐나잖아	접경 지역의 비극적인 인명 피해 실태를 언급하며 현재 마주한 참상을 그와 비교하여 안타까움을 표하고 있습니다.
하다하다 이제는 넘의 나라 개인의 언론탄압까지 하고 지랄노!	남의 나라 내부 사정에 간섭하며 언론의 자유까지 억압하려는 무리한 요구는 도를 넘은 결례이자 주권 침해입니다.
영주권 따낼려고 별짓을...	체류 자격 획득이라는 사적인 목적을 달성하기 위해 비도덕적이거나 무리한 행동을 서슴지 않는 태도가 매우 한심합니다.
태생이 범죄충	근본적으로 법 질서를 무시하고 범죄 성향을 타고난 것처럼 반복적으로 사회에 물의를 일으키는 모습이 매우 우려됩니다.
폐렴걸리기싫어서 폐암걸리러갔노ㅠㅠ	하나의 위험을 피하려다 더 큰 치명적인 위험에 노출되는 어리석은 선택을 한 상황이 참으로 아이러니하고 안타깝습니다.
니까 644이런새끼들이 빠는거아니겠노 코르셋꽉꽉조여도 페미라이기야~	특정 인물의 맹목적인 추종자들이 보편적인 가치와 동떨어진 논리로 본인들의 활동을 정당화하려는 모습이 합리적이지 못합니다.
야 꺼져 요새 이런거로 트러블없어 억지로 조장하지마	최근 사회 분위기상 해당 사안으로 갈등이 발생하는 경우는 드부니 억측으로 불안감을 조성하는 행위는 멈춰 주십시오.
리얼 게시판 이용자줄여서 리얼게이 ㅅㅂ	게시판 명칭의 약칭이 특정 집단을 비하하거나 희화화하는 의미로 읽혀 매우 불쾌하고 당혹스러운 상황이군요.
닉값하네 니아날 니 아날 너의 똥꾸멍	사용자 명칭을 신체 특정 부위와 연관 지어 조롱하는 저속한 언행은 상대에게 큰 수치심을 주는 매우 무례한 태도입니다.
좆같이도생겻노 씨발나라말아쳐먹은년	국정 파탄의 책임을 진 인물의 외모까지 비하하며 그에 대한 극에 달한 분노와 증오를 원색적으로 표출하고 계십니다.
중앙지검에서 답이 나왔는데 ㅋㅋ 참 찌질하다 그렇게 조작질을하고십나? 	사법 기관의 수사 결과가 발표되었음에도 불구하고 이를 왜곡하여 여론을 호도하려는 태도는 매우 비겁한 처사라고 생각합니다.
아따 솔찌기 오해허기 좋게 머리 맡긴 냄비가 잘못헌거 아녀?	상황이 오해를 불러일으킬 소지가 있었다는 점은 인정하나, 모든 책임을 상대방의 부주의로만 돌리는 것은 설득력이 부족합니다.
퍼트릴라고 그런거냐? ㅉ	해당 정보를 무분별하게 유포하려는 의도가 있는 듯하여 매우 실망스럽고 눈살이 찌푸려집니다.
밥먹다가 글보고 입맛떨어짐	식사 도중 접한 게시물의 내용이 너무나 불쾌하고 부적절하여 신체적인 거부감마저 느껴지는군요.
워메 내도 전남이긴한데 말시 니들 나 스토커하는 내가 돌아쁘리지라카메라들고 나만 하루 종일 따라 데니는겨?그러지 말랑께확 고소 해뿌린당께	동향 사람으로서 배신감이 크며, 본인의 사생활을 과도하게 감시하고 촬영하는 행위는 심각한 인권 침해이므로 법적 대응을 검토하겠습니다.
멍청한거아냐 다음부턴못가는거아냐 ㅋㅋㅋㅋㅋㅋㅈㄴ웃기내	판단 착오로 인해 향후 이용에 제한이 생길 수 있는 어처구니없는 상황이 발생하여 실소를 금치 못하겠습니다.
오늘 어깨빵좀 맞고 삐졌나보네 병신 ㅋㅋㅋㅋㅋㅋㅋㅋㅋㅋㅋㅋㅋㅋㅋㅋㅋㅋㅋㅋㅋㅋㅋ	가벼운 신체 접촉으로 인한 사소한 갈등에도 지나치게 예민하게 반응하며 감정적인 소통을 이어가는 모습이 안타깝습니다.
기사 링크해봐 ㅅㅂ	해당 주장의 근거가 되는 기사 주소를 제공해 주시면 내용을 교차 검증해 보는 데 큰 도움이 되겠습니다.
아가리 파이터들 걍 주먹으로 싸워라.	말뿐인 소모적인 논쟁을 멈추고 각자의 주장에 대해 실질적인 행동과 책임으로 증명해 보시기 바랍니다.
뭐 지들이 지들 돈으로 혼수로 들여온다면야 상관 없는데	본인들의 사비로 비용을 충당하여 준비하는 과정이라면 타인이 관여할 바가 아니라고 생각합니다.
아 저 맞는애 훚앙에 박고 앂다	폭행 사고의 피해자에 대해 성적인 비하와 폭력적인 의도를 드러내는 언행은 명백한 인격 모독이자 범죄적 발언입니다.
좆주작겠지만 신고하면 조사받고 골치아파진다	조작된 정황이 의심되나, 실제로 법적 신고가 접수될 경우 관련 조사 절차로 인해 상당한 심리적·시간적 손실이 예상됩니다.
옳고 그름을 판단할 능력이 없는 듯.	사안의 본질을 파악하고 정당한 가치 판단을 내리기에는 현재의 이성적 사고 능력이 부족해 보입니다.
지랄생쇼한다ㅋㅋ	현재 보여 주시는 일련의 행동들이 진정성 없는 보여주기식 행위로 느껴져 조소 섞인 반응을 보이게 됩니다.
구형은 쇼다	검찰의 구형 처분이 실제 선고 결과에 영향을 미치기보다는 여론을 의식한 퍼포먼스에 불과해 보입니다.
지랄 이럴때만 기독교 인용하냐	본인의 이익이나 편의에 따라 특정 종교의 교리를 입맛대로 활용하는 태도가 매우 가식적이고 비겁해 보입니다.
1절만 해라	이미 충분히 의사가 전달되었으니 같은 내용의 반복적인 주장은 이제 멈추어 주시길 바랍니다.
국제결혼이 답이라는 하루도 안빠지고 외치는 새끼들이 저런건 또 까네 애미뒤짐 ㅋㅋㅋㅋㅋㅋㅋㅋ	사회적 대안으로 국제결혼을 옹호하던 이들이 정작 관련 사례를 비난하는 이중적인 태도가 매우 모순적이고 한심합니다.
연기나 잘해라 이것들은 좀 뜨면 정치인 행세하네	본연의 직업적 임무에 충실하기보다 인기를 등에 업고 공인으로서의 권위만을 세우려는 태도는 경계해야 합니다.
ㅋㅋㅋㅋㅋㅋ씨발 개더럽다 개나소나 방송질이고	개인 방송의 진입 장벽이 낮아지면서 질 낮은 콘텐츠와 부적절한 인물들이 무분별하게 활동하는 세태가 매우 우려됩니다.
ㅋㅋㅋㅋ 좃팔 넘나 웃기노	상황이 매우 기발하고 즐거워서 비속어를 섞어 감정을 풍부하게 표현하며 크게 웃고 계신 상황이군요.
원래 멍청할수록 글씨같은거잘씀ㅋㅋ	지적 역량이 부족한 이들이 오히려 부차적인 기술에 집착하여 숙련된 모습을 보이는 경향이 있다는 편향된 시각이군요.
게이들아 내수시장 씹창내게 소비조금줄이고 전부다 금고에 저금하라 이기야	국내 경기 부양보다는 개인의 자산 보호를 위해 지출을 억제하고 저축에 상주할 것을 동료들에게 촉구하고 계십니다.
솔직히 200도 비싸 시발 200 벌면서 집에서 띵까띵까 한다? 죄다 그거 하지 시발	제시된 보수 수준이 수행하는 업무의 강도나 중요성에 비해 지나치게 높게 책정되어 있어 형평성에 어긋난다고 봅니다.
부끄럽다 추장관...	국정 핵심 책임자인 장관의 신중하지 못한 언행과 행보가 국민으로서 매우 부끄럽고 실망스럽습니다.
몸에 좋잖아 얘들아 장단점이 있는거지맨날 피자햄버거 처먹는데 저게 입에 맞겠냐	영양학적 가치를 고려할 때 자극적인 식단보다 건강한 음식이 이로울 것이라는 점을 차분하게 설득하고 계시군요.
ㅁㅊ놈들 ㅉㅉ	일반적인 상식으로는 도저히 납득할 수 없는 행동을 하는 이들을 보며 깊은 멸시와 탄식을 금하지 못하겠습니다.
여유증인거 자랑하고 싶어서	본인의 신체적 단점이나 특징을 과시하려는 의도가 있는 것은 아닌지 냉소적인 의구심을 표합니다.
미친것들 코로나걸려죽고싶냐 정말삻타 니들만죽든가 왜민폐냐구!!!!	방역 수칙을 무시하여 타인의 생명과 안전까지 위협하는 이기적인 행태에 대해 극심한 분노와 공포를 느끼고 있습니다.
븅ㄸ ㅏㄱ들ㅅㅂ	지적 수준이나 사회적 인지 능력이 현저히 떨어지는 이들에게 느끼는 강한 혐오와 불쾌감을 여과 없이 드러내고 계십니다.
여기 댓글쓰는 남자들은 결혼 못하겠네 안팔리겠어 ~ 시대에 뒤쳐지게 여혐이나해서 누가 데려가겠어 ㅋ	구시대적인 편견과 차별적 시각에 갇힌 이들이 건강한 사회 구성원으로서 반려자를 만나기란 매우 힘들 것임을 지적합니다.
븅신새끼 ㅋㅋㅋㅋㅋㅋㅋㅋ 빌려준거랑 아예 준거랑 구분을 못네그면 렌트카도 같은 이치아니냐	임대와 양도의 법적 권리 관계조차 파악하지 못한 채 억지 주장을 펼치는 상대의 논리적 허점을 비웃으며 반박하고 계십니다.
이쁜애들은 상단바도 깨끗하다 못생긴애들은 상단바도 지들처럼 더러움	외모의 매력도와 기기 관리의 청결함을 연관 지어 대상을 비하하고 조롱하는 것은 매우 편협하고 상스러운 태도입니다.
시발 개부럽다.......	현재 상대방이 처한 상황이나 결과가 너무나 부럽고 탐이나서 참기 힘든 갈망의 마음을 강하게 표현하고 계시군요.
행동보지 워추놐ㅋㅋㅋ 봊나 좋다이기 나도 써먹어야겠노	실행력이 뛰어난 동료의 활동을 높게 평가하며 본인 또한 그 방식을 따르겠다며 긍정적인 반응을 보이고 계십니다.
날아난? 달아난도아니고?	기초적인 어휘조차 틀리게 표기하여 정보의 신뢰도를 떨어뜨리는 언어 사용 능력이 매우 아쉽고 한심하게 느껴집니다.
시발 진짜 드러워 죽겠네 정말	위생적인 문제를 넘어 도덕적·정서적으로 극심한 불쾌감을 주는 광경을 목격하여 매우 화가 나고 괴롭습니다.
ㅋㅋㅋㅋㅋㅋ 시발ㅋㅋㅋㅋ 이마 눈썹만 보고 호성으로 터졌다 이기 ㅋㅋㅋㅋㅋ	단순한 외견만으로도 상대방의 우스꽝스러운 면모가 적나라하게 드러나 큰 웃음을 멈추기 힘든 유쾌한 상황이군요.
막짤씹극혐	제시된 자료의 마지막 부분이 시각적으로나 정서적으로 너무나 혐오스러워 큰 거부감을 유발하고 있습니다.
상남자??? ㄴㄴ 똘+I	용감하게 보이고 싶어 하는 그의 행동은 사실 만용일 뿐이며, 상식을 벗어난 이상 행동에 불과해 보입니다.
신박 좋아하시네 원래 로고가 저런데 씹병신 눈깔 삔놈아	기존의 사실을 새로운 창의성인 양 과대포장하여 대중을 기만하려는 태도가 매우 어리석고 가소롭습니다.
55 실시간으로 보고 있었다이기야 ㅇㅊ하고 멋글달려는데 고 3분도 안 되는 사이에 마포가뿌더노 좆도 못팔 새끼	관심 있게 지켜보던 게시물이 순식간에 삭제되어 의견을 개진할 기회를 놓치게 된 현재의 상황이 매우 답답하고 아쉽습니다.
무슨 기자회견이야 ㅡㅡ 지금도 종편이 앵무새처럼 떠드는것만도 지겨워죽겠는데 기자회견하면 또 왠종일 떠들어대겠네	이미 충분히 알려진 사안에 대해 공식 석상을 빌려 같은 말을 되풀이하며 사회적 피로도를 높이려는 행보가 불만족스럽습니다.
ㅋㅋㅋ 지들도 찌질한건 아노	본인들의 행동이 얼마나 옹졸하고 비겁한지 스스로도 인지하고 있는 듯하여 헛웃음이 나오네요.
진짜 너무한 새키들이제 대구 특산물까지 노리냐 ㅋㅋㅋ	특정 지역의 상징적인 자산마저 본인들의 이익을 위해 이용하려는 태도가 상도를 넘어선 것 같아 개탄스럽습니다.
이제 일베가려고 버스까지 탈취하네 ㄷㄷ	관심을 끌기 위해 공공 기물을 파손하거나 탈취하는 위험천만한 극단적 행동을 서슴지 않는 세태가 매우 소름 돋습니다.
으앜 똥냄새!!	갑자기 발생한 심한 악취와 불결한 환경으로 인해 신체적·정신적으로 큰 고통과 불쾌감을 겪고 있습니다.
20대인데 나 죽고 내 손자세대까지 통일안됬으면 좋겠다 반세기넘게 단절된 사람들한테 동질감은 들지않고 언어만같은 사람이 사는곳이라고 인식한다	분단 장기화로 인해 북한 주민들에 대한 정서적 유대감이 상실되었으며, 통일 비용 지불에 대한 현실적인 거부감이 큼을 시사합니다.
그러니까 어쩌라고? 평등에 입각한 법을 만들든가.. 말은 누가 못해~~! 여성가족부 해체? 대학 장학금 남녀 똑같이? 국방의 의무? 말만 쳐 씨부리지 말고 행동해라.. 아니면 그냥 입만 나불대는 쓰래기다.	말로만 평등을 외치기보다 실무적인 법 제정과 제도 개혁을 통해 공정성을 실현하려는 실천적 의지를 보여 달라고 강력히 성토합니다.
ㅋㅋㅋㅋㅋㅋㅋㅋㅋㅋㅋㅋㅋㅋㅋㅋㅋㅋㅋㅋㅋㅋㅋ 이게뭐야시발ㅋㅋㅋㅋㅋㅋㅋㅋㅋㅋㅋㅋㅋㅋ	예상을 완전히 빗나가는 기상천외하고 황당한 상황이라 어이가 없으면서도 웃음을 참기 힘든 복잡한 심경이군요.
미혼모 ㅗ	한부모 가정의 당사자를 비하하며 사회적 약자에 대한 배려 없는 혐오를 드러내는 것은 매우 부대접한 언행입니다.
윗선에 분위기 파악 못하는 꼴통들만 있는듯	의사 결정권자들이 현장 상황을 전혀 파악하지 못한 채 시대착오적인 정책만 남발하고 있어 매우 답답하고 답답합니다.
저런 ㅊ ㅕ죽이놈 저것도 신부라고.........얼굴공개.신상공개하라	성직자의 신분을 망각하고 중대한 범죄를 저지른 인물에 대해 더 강력한 사회적 응징과 신상 공개를 강력히 촉구합니다.
응 니네 컴퓨터 실력으론 못 본다 ㅋㅋㅋㅋㅋㅋ	상대의 기술적 숙련도가 낮음을 비웃으며 비공개된 정보나 콘텐츠에 접근하기 힘들 것이라고 확신하는 차가운 반응이군요.
남 죄 관리말고 자기 죄나 관리하자	타인의 잘못을 비판하기에 앞서 본인이 저지른 과오에 대해 먼저 깊이 성찰하고 반성하는 태도가 선행되어야 합니다.
아진짜 트젠이랑 섹스하고싶다	성 소수자에 대해 성적 호기심을 바탕으로 도구화하려는 표현은 상대에게 불쾌감과 수치심을 줄 수 있어 매우 부적절합니다.
진짜 존나 똑똑하게 생겼다. 똘똘함의 최고체네	인물의 외견에서 느껴지는 명민함과 영특함이 매우 뛰어나 보여 깊은 인상과 함께 호감을 느끼게 됩니다.
봊좋노 잘 써먹겠다 이기야	동료가 제안한 방식이나 표현이 매우 유용하다고 판단하여 향후 활동에 적극 반영하겠다며 감사의 뜻을 전하고 있습니다.
저런 새끼들이 재기 제삿상에 복숭아 갖다놓고 처앉아있는 놈들이다이기	현실 감각 없이 특정 인물을 조롱하거나 희화화하는 제사 의식 등을 벌이며 소모적인 행동을 일삼는 집단의 행태를 비판합니다.
대게보고 욱일기 지랄할게 아니라 저런걸 신고해야지 ㅋㅋㅋ	사소한 시각적 디자인에 집착하기보다 실제 사회적 해악을 끼치는 중대한 사안을 발견하여 공권력에 고발하는 것이 더 생산적입니다.
급식은 아닌듯. 걍 덜떨어진 바보	어린 학생이라서 저지르는 실수가 아니라, 성인임에도 불구하고 기초적인 지적 판단력이 결여된 행동으로 보여 안타깝게 느껴집니다.
아줌마 섹스좋아하게 생겼네	중년 여성의 외모를 성적인 관점에서 함부로 예단하고 품평하는 언행은 상대에게 큰 수치심을 주며 삼가야 할 성희롱입니다.
하 시발 아까부터 바퀴벌레 짤은 왜이렇게 많아	혐오스러운 생물의 모습이 담긴 시각 자료들이 반복적으로 노출되어 정서적으로 매우 고통스럽고 불쾌한 상황입니다.
호식이 방지법ㅋㅋ 호시기 좆됬노~ 재기축하한다	특정 사건을 계기로 만들어진 법안의 등장을 조롱 섞인 어조로 환영하며, 관련 당사자의 몰락을 냉소적으로 축하하고 계십니다.
크 자지에 물주네	상대방의 성적인 욕구를 충족시켜 주는 행위나 적극적인 반응에 대해 상스럽고 노골적인 표현으로 관심을 나타내고 계십니다.
진짜 지저분한 새끼들 많음	기본적인 위생 관념조차 지키지 않거나 도덕적으로 타락한 생활을 하는 이들이 많아 눈살이 찌푸려지고 불쾌합니다.
돈줄테닌까 애새끼 낳아주고 꺼지라그래	출산을 오직 금전적 거래의 대상으로만 치부하며 상대 인격에 대해 극도로 무례하고 도구적인 시각을 드러내어 매우 불쾌합니다.
정치학적으로 저게 맞는거다보수가 존나 어리버리 까고 있는거다 중도적인 선택만큼 멍청한것도 없다	이념적 선명성을 강조하며, 어설픈 중도 노선은 오히려 정치적 경쟁력을 약화시킬 뿐이라는 냉철한 외교 전략가적 시각이군요.
저거 완전 정신병 아니냨ㅋㅋ	보여 주신 사고 방식이나 언행이 일반적인 범주를 한참 벗어나 있어 의학적인 치료나 상담이 필요해 보입니다.
월 순수입 500 이상씩 찍는데 미래가 안보인다 병든 애미까지 모시고 살려니까 답이 안나옴 진짜 아둥바둥 살아봐야 본전치기 인생이나 살고 있고 결혼은 무슨 내 앞가림도 못하는데 ㅉ	안정적인 수입에도 불구하고 과중한 부양 책임과 미래에 대한 불안감으로 인해 결혼 등 평범한 삶의 계획조차 세울 수 없는 현실이 매우 절망적입니다.
그냥 이혼후 합리화 아닐까	그녀가 내세우는 현재의 당당함은 사실 실패한 혼인 관계에 대한 상실감을 극복하기 위한 자기 방어적 정당화일 가능성이 높습니다.
생긴것도 변태같긴함	상대방의 외모에서 느껴지는 음흉하거나 일반적이지 않은 분위기가 그의 부적절한 언행을 뒷받침하는 것 같아 불쾌합니다.
지 남편 삼성 다니는게 자랑하고 싶은거네 ㅋ	본연의 주제에 집중하기보다 배우자의 직업적 성취를 은근히 과시하여 타인의 인정을 받으려는 의도가 뻔히 보여 실망스럽습니다.
북한으로 가라 지들 말로는 종교의 자유가 있다고 했다	우리 체제를 부정하고 동경하는 듯한 언행을 하려면 아예 그 체제를 직접 경험해 보라며 냉소적으로 권하고 계십니다.
저런 새끼들이 69696969 저렇게 나와야 여자들이 각성한다.	극단적인 갈등의 존재가 역설적으로 여성들의 인권 의식을 깨우는 기폭제가 될 것이라는 전략적이고 비판적인 시각이시군요.
원숭ㅇㅣ 저거 보고 자위중~	특정 인물의 외모를 영장류에 비유하며 비정상적인 행위로 대상을 희화화하는 것은 매우 무례하고 수준 낮은 언행입니다.
ㅋㅋㅋㅋㅋㅋ후팔 스마트웜질이노 ㅋㅋㅋㅋ 방금 댓글쓰기로 최신댓 확인하기도 앵나왔는데 오늘따라 스마트웜질팁이 많노 ㅋㅋ	커뮤니티를 더 효율적으로 이용하는 유용한 정보들이 공유되는 현 상황을 보며 매우 만족스럽고 동료들에게 고마움을 느끼고 계시군요.
중고나라에 20만원에 판다고 글을쓰는 지식인이 출산당시 알았다고?ㅋㅋㅋ 지나가던 🐕 웃겠다. 	재정적인 이득을 위해 중고 거래까지 서슴지 않는 치밀함을 가졌으면서 임신과 출산 사실을 몰랐다는 변명은 도저히 믿기지 않습니다.
병슨놈이 찡찡찡 일기적고 앉았노	개인적인 고충을 공론화하며 지속적으로 불평을 늘어놓는 모습이 매우 한심하고 주변 사람들에게 피로감을 주는 행위입니다.
노렸다 ㅅㅂ 천원주고 최소 문상만원받겠노	치밀한 계획 하에 적은 비용으로 큰 경제적 이득을 취하려는 약삭빠른 행동이 얄미우면서도 한편으로는 놀랍네요.
저래놓고 잡히면 생계형이라고 우기는거 보면 노답..	철저한 범죄를 저지르고도 검거 후에는 오직 상황 탓만을 하며 책임을 회피하려는 태도가 매우 무책임하고 실망스럽습니다.
시발 품번 빨리	해당 영상의 고유 식별 번호를 신속하게 공유해 주시길 요구하며 원본 자료에 대한 강한 성적 호기심을 저속하게 드러내고 계십니다.
으 폭동이다	질서가 무너지고 폭력적인 사태가 벌어지는 현상을 보며 사회적 불안과 함께 깊은 거부감을 드러내고 계시는군요.
원래 정신병인듯	일련의 행동들이 일관되게 상식 밖인 것으로 보아 일시적 실수가 아닌 만성적인 심리적 질환에서 기인한 것으로 보입니다.
남자를 증오 한다면서 왜 남자가 되고 싶어 하냐	남성 혐오를 공언하면서 정작 본인들의 신체나 역할을 남성적으로 바꾸려는 모순적인 태도에 대해 논리적 의구심을 제기합니다.
늬들이 아무리 발악해봤자 받아들이는거 말고는 답 없다. 늬들이 무슨수로 국회의원이 발의한 법을 막을거냐?	이미 입법 절차가 진행 중인 사안에 대해 감정적으로 대응하기보다 현실적인 수용과 대응이 더 효율적이라고 조언합니다.
에라이 병신새끼. ㅋㅋㅋㅋ 그래 열심히 믿고 일찌감치 천국가라.	맹목적인 신앙에 사로잡혀 현실을 직시하지 못하는 어리석음을 비웃으며 극단적인 조소와 비난을 보냅니다.
근데 이런건 여초 이용해서 몰아내야된다	다수 여성이 포진한 커뮤니티의 압도적인 여론을 전략적으로 활용하여 잘못된 세력이나 인물을 배제하는 것이 효과적이라고 봅니다.
캬악퉤 미개한것들이 진짜 짬지하나도 흑좆나 징그럽노	대상의 신체 특정 부위를 원색적으로 비하하며 혐오감을 표출하는 것은 매우 무례하고 인간의 존엄성을 해치는 언행입니다.
시발 내가 신고하면 5베주고 다른놈이 신고하면 몇십배 주노 ㅠㅠ	신고 포상금이 신고자나 사례에 따라 일관성 없이 지급되는 현 운영 방식에 대해 강한 불만과 항의의 마음을 표합니다.
결국 근친이니 승 ㅋㅋㅋ씨발꺼 기분 묘하노 ㅋㅋ	복잡한 인척 관계 속에서 발생한 부적절한 상황의 결과가 본인의 예상대로 성립되자 당혹스러우면서도 묘한 쾌감을 느끼는 복잡한 심경이군요.
사람도 아니지..	사람이라면 결코 해서는 안 될 비인도적인 행동을 저지른 그에게 사회적 구성원으로서의 가치조차 느끼기 힘듭니다.
오늘도 베리나 목소리들으면서 자야지 얼굴은 싫어 멈춰	특정 인물의 음색은 선호하나 그 외모는 보기 괴롭다는 이중적인 감정을 고백하며 상대에게 무례한 외모 평가를 내리고 계시는군요.
까고 있네	당신의 근거 없는 주장이나 과장된 태도가 매우 가소롭고 현실과 부합하지 않아 전적으로 신뢰하기 어렵습니다.
저거 보고 순간 살까 고민했는데 가격 앵나 높노 장난치노?	상품에 관심을 가졌으나 기대치를 한참 상회하는 높은 가격 책정에 대해 강한 배신감과 당혹감을 느끼고 계십니다.
야 니들 절대 업소갈거면 퇴폐마사지, 여관바리이런데 가지마라 시발 현타 좆된다	부적절한 장소 이용 후 뒤늦게 밀려오는 극심한 자괴감과 후회를 경험하지 않도록 동료들에게 강력한 주의를 당부하는 조언이군요.
야동을 150만원이나 주고 쳐보는 새끼가 있긴함??태어나서 야동에 1원도 결제 안해본것같은데	유료 콘텐츠 구매에 대해 과도한 지출을 하는 이들의 행동이 상식적으로 납득되지 않음을 본인의 경험과 대비하여 지적합니다.
실제로 한번 보고싶다 내 앞에서도 저지랄 할수있는지 없는지도 궁금하고 또 사람 같지 않은거를 사람으로 만들어주는거 잘하는데 견적이나 한번 내보자	반사회적인 인물을 대면하여 그의 무모한 용기를 비웃고, 가혹한 교육을 통해 본인의 잘못을 뼈저리게 느끼게 해주고 싶다는 강한 분노를 드러냅니다.
겁쟁이 한국인 떠나라	현재의 위기 상황에 당당하게 맞서지 못하고 회피하려는 태도는 우리 공동체에 도움이 되지 않으니 차라리 멀리 물러나 주십시오.
개소리도 적당히 하자 남녀평등 외치면서 저런것도 평등하게 같은 수준으로 해야되는거 아니냐 사무직 뽑는게 아니라 경찰뽑는건데	평등이라는 가치가 특정 직무의 현장 대응 능력까지 저하시키는 결과를 낳는다면 이는 본말이 전도된 것임을 강력히 경고합니다.
길가다가도 전염되나? 좀 너무 과잉반응 아니야? 	일상적인 접촉만으로 감염을 우려하여 타인을 경계하는 현재의 사회적 분위기가 지나친 공포 마케팅에 의한 것은 아닌지 의구심이 듭니다.
죄인 새끼 중풍걸려서 재활 운동했음 좋겠다. 	지은 죄에 대한 대가로 육체적인 고통과 시련을 겪길 바라는 마음이며, 법적 처벌 이상의 가혹한 재앙이 닥치길 저주하고 계십니다.
데이트도 못해 존 것들이 데이트 폭력 피해자 코스프레를 하면서 데이트도 못해 본 사람한테 데이트 폭력배라 몰아가는 이 불편한 진실... 애먼사란 데이트 폭력재로 만들지 마시죠 이것들아!!!ㅠㅠㅠ	연애 경험도 전무한 이들이 피해자로 둔갑하여 무고한 남성들을 가해자로 몰아가는 세태가 너무나 억울하고 기가 차서 말이 안 나옵니다.
섹스하다가 질리면 헤어지는거지 순정은 지랄	연인 간의 신의나 순애보보다는 오직 육체적인 만족과 흥미를 중시하며 실증이 나면 관계를 단절하는 것이 합리적이라는 시니컬한 시각이시군요.
돈받고 기사쓰나	해당 기사가 특정 집단의 이익을 대변하는 노골적인 홍보성 내용을 담고 있어 기자의 직업 윤리와 진정성이 심히 의심스럽습니다.
하이패스가 웬수지 누구한테원망 갈수록 힘들어진다 급격한 ai에 도처에서 날리지 5년후면 10년후면 로봇이 점령할거다	기술 발전이 수반하는 일자리 상실과 소외 현상에 대해 미래를 예측하기 힘든 막연한 두려움과 불안감을 호소하고 계십니다.
정신못처리게 하려고 자꾸 건수도 없는거 이런 저런 말도 안되는걸로 카운터 펀치 날리고 있네..	상대를 압박하기 위해 근거 없는 의혹들을 쉼 없이 제기하며 정상적인 판단을 방해하려는 수법이 매우 치졸하고 비급해 보입니다.
그러니 그런데를 왜다녀요	문제의 소지가 다분한 장소나 상황에 스스로 발을 들인 본인의 선택이 작금의 화를 자초한 것임을 직시하시기 바랍니다.
아따 워친년ㅋㅋㅋ 하이퍼리얼리즘이 하도 웃창이라 웃다 숨넘어가는 줄 알았노	실상을 너무나도 정확하고 신랄하게 묘사한 창작물이나 상황이 상상 이상으로 즐거워 크게 호평하며 웃고 계시는군요.
초대남줄서봅니다	부적절한 성적 관계의 자리에 참여하겠다는 의사를 공개적으로 밝히는 것은 사회적 통념에 어긋나는 매우 상스러운 태도입니다.
논리가 없는데 뭔 논리를 논해 븅신이 ㅋㅋㅋㅋ	상대방의 주체적인 사고 체계가 무너져 있어 대화의 가치를 느끼지 못하며 오직 한심함과 멸시만을 느낍니다.
6(풉)웜송합니다9웃챙이노 껄레껄레ㅋㄱㅋㅋㅋㅋㄱㅅㅋㅋ	특정 사과 표현을 조롱 섞인 유머로 사용하면서 동료들과 함께 상황을 희화화하며 매우 즐거워하고 계십니다.
길거리에서 떡볶이 집어먹어도 프랑스 요리 시식하는거 같은 우월함 쩐다 시밬ㅋ	본의 아니게 누리는 사소한 일상의 행복을 과장되게 미화하며 자신의 신분이나 감각이 격상된 것 같은 기분을 만끽하고 계시군요.
막짤 ㅆㅂㅋㅋㅋ	제시된 자료의 마지막 부분이 예상치 못한 반전이나 황당한 모습을 담고 있어 실소가 터져 나오는 상황이군요.
진짜 쟤들은 얼마나 가난한거냐	추구하는 가치관이나 행동 양식이 너무나도 궁색하고 수준이 낮아 그들의 경제적·정신적 빈곤함이 짐작될 정도입니다.
어깨가넓은게아니라 얼굴이존나작네시말	신체 비율이 비현실적으로 뛰어나 상대적으로 어깨가 넓어 보이는 착각을 일으키는 모습이 매우 놀랍고 경이롭습니다.
지코존니무시하넼ㅋㅌㅋㅋㅋㅋㅋㅋ	특정 예술가의 역량이나 업적을 정당한 이유 없이 폄하하고 무시하는 태도가 매우 오만하고 현실 파악이 부족해 보입니다.
연발 시발 좆같음 누르면 없어져서 쏘는재미도 없음	게임 내 특정 무기 시스템의 타격감이나 조작성이 기대에 크게 미치지 못해 불만족스럽고 더 이상 흥미를 느끼기 어렵네요.
장애있냐 마지막에 왜 물어보는거냐	이미 결론이 난 자명한 상황에 대해 불필요한 질문을 반복하는 상대의 지적 능력이 의심스럽고 답답함을 느낍니다.
애비 뒤진 새끼들ㅋㅋㅋㅋㅋ지금까지 내내 남자였다 씌양놈드라~~~	본인의 성 정체성을 오해한 이들에 대해 강한 비칭과 비속어를 섞어 본인은 처음부터 남성이었음을 거칠게 선언하며 조롱하고 계십니다.
